    Gs,    Gs,    Gs,    Hh,    Gs,    Gs,    Gs,    Gs,    Gs,    Hh,    Gs,    Gs,    Gs,    Hh,    Hh,    Hh,    Hh,    Hh,    Hh,    Hh,    Gs,    Hh,    Gs,    Hh,    Gs,    Gs,    Gs,    Hh,    Gs,    Gs
    Gs,    Gs,    Gs,    Hh,    Hh,    Hh,    Gs,    Gs,    Gs,    Hh,    Gs,    Hh,    Gs,    Hh,    Hh,    Hh,    Hh,    Hh,    Hh,    Hh,    Hh,    Hh,    Hh,    Hh,    Gs,    Hh,    Hh,    Hh,    Hh,    Hh
    Gs,    Gs,    Gs,    Hh,    Hh,    Hh,    Gs,    Hh,    Gs,    Gs,    Hh,    Gs,    Hh,    Hh,    Hh,    Hh,    Hh,    Hh,    Hh,    Hh,    Hh,   Hh^Vhh,    Hh,    Hh,    Hh,    Hh,    Gs,    Gs,    Hh,    Gs
    Gs,    Gs,    Gs,    Gs,    Hh,    Hh,    Hh,    Hh,    Gs,    Gs,    Hh,    Hh,    Gs,    Hh,    Hh,    Hh,    Hh,    Hh,    Hh,    Hh,    Hh,    Hh,    Hh,    Gs,    Hh,    Hh,    Hh,    Gs,    Gs,    Gs
    Gs,    Gs,    Gs,    Gs,    Hh,    Hh,    Gs,    Hh,   Hh^Vhh,    Gs,    Gs,    Gs,    Hh,    Hh,    Hh,    Hh,    Hh,    Hh,    Hh,    Gs,    Hh,    Hh,    Hh,    Gs,    Hh,    Gs,    Gs,    Gs,    Gs,    Gs
    Gs,    Gs,    Gs,    Gs,    Gs,    Hh,    Gs,    Hh,    Hh,    Hh,    Gs,    Hh,    Hh,    Hh,    Hh,    Hh,    Hh,    Hh,    Hh,    Gs,    Gs,    Gs,    Hh,    Hh,    Hh,    Gs,    Gs,    Gs,    Gs,    Gs
    Gs,    Gs,    Gs,    Gs,    Gs,    Gs,    Hh,    Gs,    Hh,    Hh,    Hh,    Hh,    Hh,    Hh,    Hh,    Hh,    Hh,    Hh,    Hh,    Gs,    Gs,    Hh,    Hh,    Hh,    Gs,    Gs,    Gs,    Gs,    Gs,    Gs
    Gs,    Gs,    Gs,    Gs,    Gs,    Gs,    Gs,    Gs,    Hh,    Hh,    Gs,    Hh,    Hh,   Hh^Vhh,    Hh,    Hh,    Hh,    Hh,    Hh,    Hh,    Hh,    Hh,    Hh,    Gs,    Gs,    Gs,    Gs,    Gs,    Gs,    Gs
    Gs,    Gs,    Gs,    Ce,    Gs,    Gs,    Gs,    Hh,    Hh,    Hh,    Gs,    Hh,    Hh,    Hh,    Hh,    Hh,    Hh,    Hh,    Gs,    Gs,    Hh,    Hh,    Gs,    Gs,    Gs,    Ce,    Gs,    Gs,    Gs,    Gs
    Gs,    Gs,    Ce,  1 Ke,    Ce,    Gs,    Gs,    Hh,    Hh,    Hh,    Hh,    Gs,    Hh,    Hh,    Hh,    Hh,    Hh,    Hh,    Hh,    Gs,    Gs,    Hh,    Gs,    Gs,    Ce,  3 Ke,    Ce,    Gs,    Gs,    Gs
    Gs,    Gs,    Ce,    Ce,    Ce,    Gs,    Hh,    Gs,    Gs,    Hh,    Hh,    Hh,    Hh,    Hh,    Hh,    Hh,    Hh,    Hh,    Gs,    Gs,    Gs,    Gs,    Hh,    Gs,    Ce,    Ce,    Ce,    Gs,    Gs,    Gs
    Gs,    Gs,    Gs,    Gs,    Gs,    Gs,    Gs,    Gs,    Gs,    Hh,    Hh,    Hh,    Hh,    Hh,    Hh,    Hh,    Hh,    Hh,    Hh,    Hh,    Gs,    Gs,    Hh,    Gs,    Gs,    Gs,    Gs,    Gs,    Gs,    Gs
    Gs,    Gs,    Gs,    Gs,    Gs,    Gs,    Gs,    Gs,    Hh,    Hh,    Hh,    Hh,    Hh,    Hh,    Hh,    Hh,    Hh,    Hh,    Gs,    Hh,    Gs,    Hh,    Hh,    Hh,    Hh,    Hh,    Hh,    Hh,    Gs,    Gs
    Gs,    Gs,    Gs,    Gs,    Gs,    Gs,    Gs,    Gs,    Gs,    Hh,    Hh,    Hh,    Hh,    Hh,   Hh^Vhh,    Hh,    Hh,    Hh,    Gs,    Gs,    Hh,    Hh,    Hh,    Gs,    Hh,    Hh,    Hh,    Hh,    Gs,    Hh
    Gs,    Gs,    Gs,    Gs,    Gs,    Gs,    Gs,    Gs,    Gs,    Hh,    Hh,    Hh,    Hh,    Hh,    Hh,    Hh,    Hh,    Hh,    Hh,    Hh,    Gs,    Hh,    Gs,    Hh,    Gs,    Hh,    Gs,    Gs,    Hh,    Gs
    Gs,    Gs,    Gs,    Gs,    Gs,    Gs,    Gs,    Hh,    Gs,    Hh,    Hh,    Hh,    Hh,    Hh,    Hh,    Hh,    Hh,    Hh,    Hh,    Hh,    Gs,    Hh,    Hh,    Gs,    Hh,    Hh,    Hh,    Gs,    Gs,    Gs
    Gs,    Gs,    Gs,    Gs,    Gs,    Gs,    Gs,    Gs,    Hh,    Hh,    Hh,    Hh,    Hh,    Hh,    Hh,    Hh,    Hh,    Hh,    Hh,    Hh,    Hh,    Hh,    Hh,    Gs,    Gs,    Hh,    Gs,    Hh,    Gs,    Gs
    Gs,    Gs,    Gs,    Gs,    Gs,    Gs,    Gs,    Gs,    Gs,    Hh,    Hh,    Hh,    Hh,    Hh,    Hh,    Hh,    Hh,    Hh,    Hh,    Hh,    Hh,    Hh,    Gs,    Gs,    Gs,    Gs,    Hh,    Hh,    Gs,    Hh
    Gs,    Gs,    Gs,    Gs,    Gs,    Hh,    Gs,    Hh,    Hh,    Hh,    Hh,    Hh,    Hh,    Hh,    Hh,    Gs,    Hh,    Hh,    Hh,    Hh,    Hh,    Hh,    Hh,    Hh,    Gs,    Gs,    Hh,    Hh,    Hh,    Hh
    Gs,    Gs,    Gs,    Gs,    Gs,    Gs,    Hh,    Hh,    Hh,    Hh,    Hh,    Hh,    Hh,    Hh,    Gs,    Gs,    Gs,    Hh,    Hh,    Hh,    Hh,    Hh,    Hh,    Hh,    Gs,    Ce,    Ce,    Ce,    Hh,    Hh
    Gs,    Gs,    Gs,    Gs,    Gs,    Gs,    Hh,    Hh,    Hh,    Hh,    Hh,    Hh,    Gs,    Hh,    Gs,    Gs,    Hh,    Hh,    Hh,    Gs,    Hh,    Hh,    Hh,    Hh,    Hh,    Ce,    Ce,    Ce,    Hh,    Hh
    Gs,    Gs,    Gs,    Gs,    Hh,    Gs,    Hh,    Hh,    Hh,    Gs,    Hh,    Gs,    Gs,    Gs,    Hh,    Hh,    Gs,    Gs,    Gs,    Gs,    Gs,    Hh,    Hh,    Hh,    Gs,    Hh,  4 Ke,    Hh,    Hh,    Hh
    Gs,    Gs,    Gs,    Gs,    Hh,    Hh,    Hh,    Gs,    Gs,    Hh,    Hh,    Hh,    Gs,    Gs,    Hh,    Hh,    Gs,    Gs,    Gs,    Gs,    Gs,    Hh,    Hh,    Hh,    Gs,    Gs,    Hh,    Hh,    Hh,    Hh
    Gs,    Gs,    Gs,    Gs,    Gs,    Hh,    Hh,    Gs,    Gs,    Hh,    Hh,    Gs,    Gs,    Gs,    Gs,    Hh,    Gs,    Hh,    Gs,    Gs,   Gs^Vht,    Gs,    Gs,    Gs,    Gs,    Gs,    Hh,    Hh,    Hh,    Hh
    Gs,    Gs,    Gs,    Gs,    Gs,    Gs,    Gs,    Hh,    Gs,    Hh,    Hh,    Gs,    Gs,    Hh,    Gs,    Hh,    Hh,    Hh,    Gs,    Gs,    Gs,    Gs,    Gs,    Gs,    Gs,    Hh,    Hh,    Hh,    Hh,    Hh
    Gs,    Gs,    Gs,    Gs,    Gs,    Gs,    Hh,    Hh,    Hh,    Gs,    Gs,    Gs,    Gs,    Gs,    Hh,    Gs,    Gs,    Gs,    Hh,    Hh,    Gs,    Gs,    Hh,    Hh,    Hh,    Hh,    Hh,    Hh,    Hh,    Hh
    Gs,    Gs,    Gs,    Gs,    Gs,    Gs,    Hh,    Hh,   Gs^Vht,    Gs,    Gs,    Gs,    Gs,    Gs,    Gs,    Gs,    Gs,    Gs,    Hh,    Hh,    Gs,    Gs,    Gs,    Gs,    Hh,    Hh,    Hh,    Hh,    Hh,    Hh
    Gs,    Gs,    Gs,    Gs,    Gs,    Gs,    Hh,    Hh,    Gs,    Gs,    Gs,    Gs,    Gs,    Ce,    Ce,    Ce,    Gs,    Gs,    Gs,    Hh,    Gs,    Gs,    Gs,    Gs,    Hh,    Hh,    Hh,    Gs,    Hh,    Hh
    Gs,    Gs,    Gs,    Gs,    Gs,    Gs,    Gs,    Gs,    Gs,    Gs,    Gs,    Gs,    Gs,    Ce,  2 Ke,    Ce,    Gs,    Gs,    Gs,    Gs,    Hh,    Gs,    Gs,    Gs,    Hh,    Gs,    Gs,    Gs,    Hh,    Hh
    Gs,    Gs,    Gs,    Gs,    Gs,    Gs,    Gs,    Gs,    Gs,    Gs,    Gs,    Gs,    Gs,    Gs,    Ce,    Gs,    Gs,    Gs,    Gs,    Gs,    Hh,    Gs,    Gs,    Gs,    Hh,    Gs,    Gs,    Gs,    Gs,    Gs

