Gg     , Gg     , Gg     , Gg     , Gg     , Gg     , Gg     , Gg     , Gg     , Gg     , Gg     , Gg     , Gg     , Gg     , Gg     , Gg     , Gg     , Gg     , Gg     , Gg     , Gg     , Gs^Fp     , Gs^Fp     , Gs^Fp     , Gs^Fp     , Gs^Fp     , Gs^Fp     , Gs^Fp     , Gs^Fp     , Gs^Fp     , Gs^Fp     , Gg     , Gg     , Gg     , Gg     , Gg     , Gg     , Gg     , Gg     , Gg     , Gg     , Gg     , Gg     , Gg     , Hh     , Hh     , Hh     , Mm     , Mm     , Mm     
Gg     , Gg     , Gg     , Gg     , Gg     , Gg     , Gg     , Gg     , Gg     , Gg     , Gg     , Gg     , Gg     , Gg     , Gg     , Gs^Fp     , Gg     , Gs^Fp     , Gg     , Gs^Fp     , Gs^Fp     , Gs^Fp     , Gs^Fp     , Gs^Fp     , Gs^Fp     , Gs^Fp     , Gs^Fp     , Gs^Fp     , Gs^Fp     , Gs^Fp     , Gs^Fp     , Gs^Fp     , Gg     , Gg     , Gg     , Gg     , Gg     , Gg     , Gg     , Gg     , Gg     , Gg     , Gg     , Gg     , Gg     , Hh     , Mm     , Mm     , Mm     , Hh     
Gg     , Re     , Gg     , Gg     , Gg     , Gg     , Gg     , Gg     , Gg     , Gg     , Gg     , Gs^Fp     , Gs^Fp     , Gs^Fp     , Gs^Fp     , Gs^Fp     , Gs^Fp     , Gs^Fp     , Gs^Fp     , Gs^Fp     , Gs^Fp     , Gs^Fp     , Gs^Fp     , Gs^Fp     , Gs^Fp     , Gs^Fp     , Gs^Fp     , Gs^Fp     , Gs^Fp     , Gs^Fp     , Gs^Fp     , Gs^Fp     , Gs^Fp     , Gs^Fp     , Gg     , Gs^Fp     , Gg     , Gg     , Gg     , Gg     , Gg     , Gg     , Gg     , Gg     , Gg     , Gg     , Hh     , Mm     , Mm     , Mm     
Re     , Gg     , Re     , Re     , Gg     , Re     , Gg     , Gg^Ve    , Gg     , Gg     , Gg     , Gg     , Gs^Fp     , Gs^Fp     , Gs^Fp     , Gs^Fp     , Gs^Fp     , Gs^Fp     , Gs^Fp     , Gs^Fp     , Gs^Fp     , Gs^Fp     , Gs^Fp     , Gs^Fp     , Gs^Fp     , Gs^Fp     , Gs^Fp     , Gs^Fp     , Gs^Fp     , Gs^Fp     , 2 Kv   , Cv     , Cv     , Gg     , Gs^Fp     , Gg     , Gg     , Gg     , Gg     , Gg     , Gg^Ve    , Gg     , Gg     , Gg     , Gg     , Hh     , Hh     , Hh     , Mm     , Hh     
Gg     , Gg     , Gg     , Gg     , Re     , Gg     , Re     , Re     , Gg     , Gg     , Gg     , Gg     , Gs^Fp     , Gs^Fp     , Gs^Fp     , Gs^Fp     , Gs^Fp     , Gs^Fp     , Gs^Fp     , Gs^Fp     , Gs^Fp     , Gs^Fp     , Gs^Fp     , Gs^Fp     , Gs^Fp     , Gs^Fp     , Gs^Fp     , Gs^Fp     , Gs^Fp     , Gs^Fp     , Gs^Fp     , Gs^Fp     , Cv     , Gg     , Gg     , Gg     , Gg     , Gg     , Gg     , Gg     , Gg     , Gg     , Gg     , Gg     , Gg     , Gg     , Hh     , Mm     , Mm     , Mm     
Gg     , Gg     , Gg     , Gg     , Gg     , Gg     , Re     , Gg     , Gg     , Gg     , Gg     , Gg     , Gs^Fp     , Gs^Fp     , Gs^Fp     , Gs^Fp     , Gs^Fp     , Gs^Fp     , Gs^Fp     , Gs^Fp     , Gs^Fp     , Gs^Fp     , Gs^Fp     , Gs^Fp     , Gs^Fp     , Gs^Fp     , Gs^Fp     , Gs^Fp     , Gs^Fp     , Gs^Fp     , Gs^Fp     , Gs^Fp     , Cv     , Gg     , Gg     , Gg     , Gg     , Gg     , Gg     , Gg     , Gg     , Gg     , Gg     , Gg     , Gg     , Hh     , Hh     , Mm     , Hh     , Mm     
Gg     , Gg     , Gg     , Gg     , Gg     , Gg     , Re     , Re     , Gg     , Gg     , Gg     , Gs^Fp     , Gg     , Gs^Fp     , Gs^Fp     , Gs^Fp     , Gs^Fp     , Gs^Fp     , Gs^Fp     , Gs^Fp     , Gs^Fp     , Gs^Fp     , Gg^Ve    , Gs^Fp     , Gs^Fp     , Gs^Fp     , Gs^Fp     , Gs^Fp     , Gs^Fp     , Gs^Fp     , Gs^Fp     , Gs^Fp     , Gs^Fp     , Gs^Fp     , Gg     , Gg     , Gg     , Gg     , Gg     , Gg     , Gg     , Gg     , Gg     , Gg     , Hh     , Hh     , Hh     , Mm     , Mm     , Mm     
Gg     , Gg     , Gg     , Gg     , Gg     , Gg     , Gg     , Re     , Gg     , Gg     , Gg     , Gg     , Gs^Fp     , Gs^Fp     , Gs^Fp     , Gs^Fp     , Gs^Fp     , Gs^Fp     , Gs^Fp     , Gs^Fp     , Gs^Fp     , Gs^Fp     , Gs^Fp     , Gs^Fp     , Gs^Fp     , Gs^Fp     , Gs^Fp     , Gs^Fp     , Gs^Fp     , Gs^Fp     , Gs^Fp     , Gs^Fp     , Gs^Fp     , Gs^Fp     , Gg     , Gs^Fp     , Gs^Fp     , Gg     , Gg     , Gg     , Gg     , Gg     , Gg     , Gg     , Gg     , Hh     , Mm     , Mm     , Mm     , Hh     
Gg     , Gg     , Gg     , Gg     , Gg     , Gg     , Gg     , Re     , Gg     , Gg     , Gg     , Gs^Fp     , Gs^Fp     , Gs^Fp     , Gs^Fp     , Gs^Fp     , Gs^Fp     , Gs^Fp     , Gs^Fp     , Gs^Fp     , Gs^Fp     , Gs^Fp     , Gs^Fp     , Gs^Fp     , Gs^Fp     , Gs^Fp     , Gs^Fp     , Gs^Fp     , Gs^Fp     , Gs^Fp     , Gs^Fp     , Gs^Fp     , Gs^Fp     , Gs^Fp     , Gs^Fp     , Gg^Ve    , Gs^Fp     , Gs^Fp     , Gg     , Gg     , Gg     , Gg     , Gg     , Gg     , Gg     , Gg     , Hh     , Hh     , Mm     , Hh     
Gg     , Gg     , Gg     , Gg     , Gg^Ve    , Re     , Re     , Gg     , Gg     , Gg     , Gs^Fp     , Gs^Fp     , Gs^Fp     , Gs^Fp     , Gg^Ve    , Gs^Fp     , Gs^Fp     , Gs^Fp     , Gs^Fp     , Gs^Fp     , Gs^Fp     , Gs^Fp     , Gs^Fp     , Gs^Fp     , Gs^Fp     , Gs^Fp     , Gs^Fp     , Gs^Fp     , Gs^Fp     , Gs^Fp     , Gs^Fp     , Gs^Fp     , Gs^Fp     , Gs^Fp     , Gs^Fp     , Gs^Fp     , Gs^Fp     , Gs^Fp     , Gg     , Gg     , Gg     , Gg     , Gg     , Gg     , Gg     , Gg     , Hh     , Gg     , Hh     , Hh     
Gg     , Gg     , Gg     , Gg     , Gg     , Gg     , Re     , Re     , Gg     , Gg     , Gs^Fp     , Gs^Fp     , Gs^Fp     , Gs^Fp     , Gs^Fp     , Gs^Fp     , Gs^Fp     , Gs^Fp     , Gs^Fp     , Gs^Fp     , Gs^Fp     , Gs^Fp     , Gs^Fp     , Gs^Fp     , Gs^Fp     , Gs^Fp     , Gg^Ve    , Gs^Fp     , Gs^Fp     , Gs^Fp     , Gs^Fp     , Gs^Fp     , Gs^Fp     , Gs^Fp     , Gs^Fp     , Gs^Fp     , Gs^Fp     , Gs^Fp     , Gs^Fp     , Gg     , Gg     , Gg     , Gg     , Gg     , Gg     , Gg     , Gg     , Gg     , Hh     , Hh     
Gg     , Gg     , Gg     , Gg     , Gg     , Gg     , Re     , Re     , Re     , Gg     , Gg     , Gs^Fp     , Gs^Fp     , Gs^Fp     , Gs^Fp     , Gs^Fp     , Gs^Fp     , Gs^Fp     , Gs^Fp     , Gs^Fp     , Gs^Fp     , Gs^Fp     , Gs^Fp     , Gs^Fp     , Gs^Fp     , Gs^Fp     , Gs^Fp     , Gs^Fp     , Gs^Fp     , Gs^Fp     , Gs^Fp     , Gs^Fp     , Gs^Fp     , Gg     , Gs^Fp     , Gs^Fp     , Gs^Fp     , Gg     , Gs^Fp     , Gg     , Gg     , Gg     , Gg     , Gg     , Gg     , Gg     , Gg     , Gg     , Gg     , Hh     
Gg     , Gg     , Gg     , Gg     , Gg     , Gg     , Re     , Re     , Re     , Gg     , Gs^Fp     , Gs^Fp     , Gs^Fp     , Gs^Fp     , Gs^Fp     , Gs^Fp     , Gs^Fp     , Gs^Fp     , Gs^Fp     , Gs^Fp     , Gs^Fp     , Gs^Fp     , Gs^Fp     , Gs^Fp     , Gs^Fp     , Gs^Fp     , Gs^Fp     , Gs^Fp     , Gs^Fp     , Gs^Fp     , Gs^Fp     , Gs^Fp     , Gg     , Gg     , Gg     , Gg     , Gg     , Gg     , Gg     , Gg     , Gg     , Gg     , Gg     , Gg     , Gg     , Gg     , Gg     , Gg     , Gg     , Gg     
Gg     , Gg     , Gg     , Gg     , Gg     , Gg     , Gg     , Re     , Gg     , Gg     , Gg     , Gg     , Gg     , Gg     , Gs^Fp     , Gs^Fp     , Gs^Fp     , Gs^Fp     , Gs^Fp     , Gs^Fp     , Gs^Fp     , Gs^Fp     , Gs^Fp     , Gs^Fp     , Gs^Fp     , Gs^Fp     , Gs^Fp     , Gs^Fp     , Gs^Fp     , Gs^Fp     , Gs^Fp     , Gs^Fp     , Gg     , Gg     , Gg     , Gg     , Gg     , Gg     , Gg     , Gg^Ve    , Gg     , Gg     , Gg     , Gg     , Gg     , Gg     , Gg     , Gg     , Gg     , Gg     
Gg     , Gg     , Gg     , Gg     , Gg     , Gg     , Re     , Re     , Gg     , Gg     , Gg     , Gg     , Gg     , Gg     , Gg     , Gg     , Gg     , Gg     , Gs^Fp     , Gg     , Gg     , Gg     , Gg     , Gg     , Gg     , Gg     , Gs^Fp     , Gg     , Gs^Fp     , Gs^Fp     , Gs^Fp     , Gs^Fp     , Gs^Fp     , Gg     , Gg     , Gg     , Gg     , Gg     , Gg     , Re     , Gg     , Gg     , Gg     , Gg     , Gg     , Gg     , Gg     , Gg     , Gg     , Gg     
Gg     , Gg     , Gg     , Gg     , Gg     , Gg^Ve    , Re     , Gg     , Gg     , Gg     , Gg     , Gg     , Gg     , Gg     , Gg     , Gg     , Gg     , Gg     , Gs^Fp     , Gg     , Gg     , Gg     , Gg     , Gg^Ve    , Gg     , Gg     , Gg     , Gg     , Gs^Fp     , Gs^Fp     , Gs^Fp     , Gs^Fp     , Gg     , Gg     , Gg     , Gg     , Gg     , Gg     , Gg     , Gg     , Re     , Gg     , Gg     , Gg     , Gg     , Re     , Gg     , Re     , Gg     , Re     
Gg     , Gg     , Gg     , Gg     , Gg     , Gg     , Re     , Gg     , Gg     , Gg     , Gg     , Gg     , Gg     , Re     , Gg     , Re     , Gg     , Re     , Gg     , Gg     , Gg     , Re     , Gg     , Re     , Gg     , Re     , Re     , Re     , Gg     , Gg     , Gg     , Gg     , Gg     , Re     , Gg     , Re     , Re     , Re     , Gg     , Re     , Re     , Re     , Gg     , Re     , Re     , Gg     , Re     , Gg     , Re     , Gg     
Gg     , Gg     , Gg     , Gg     , Gg     , Gg     , Re     , Re     , Gg     , Re     , Re     , Re     , Re     , Gg     , Re     , Gg     , Re     , Re     , Gg     , Re     , Re     , Gg     , Re     , Gg     , Re     , Gg     , Gg     , Gg     , Re     , Re     , Re     , Re     , Re     , Gg     , Re     , Gg     , Gg     , Gg     , Re     , Re     , Re     , Gg     , Re     , Gg     , Re     , Re     , Gg     , Gg     , Gg     , Gg     
Gg     , Gg     , Gg     , Gg     , Gg     , Re     , Gg     , Re     , Re     , Gg     , Gg     , Gg     , Gg     , Gg     , Gg     , Gg     , Gg     , Gg     , Re     , Ch     , Gg     , Gg     , Gg     , Gg     , Gg     , Ww     , Gg     , Gg     , Gg     , Gg     , Gg     , Gg     , Gg     , Gg     , Gg     , Gg     , Gg     , Gg     , Gg     , Gg     , Gg     , Gg     , Gg     , Gg     , Gg     , Gg     , Re     , Gg     , Gg     , Gg     
Gg     , Gg     , Gg     , Re     , Re     , Gg     , Re     , Gg     , Gg     , Gg     , Ww     , Ww     , Ww     , Gg     , Ww     , Ww     , Gg     , Ww     , Ww     , Ww     , Ww^Bw\   , Ww^Bw\   , Ww     , Ww     , Ww     , Wo     , Ww     , Ww     , Ww     , Ww     , Gg     , Ww     , Ww     , Ww     , Ww     , Ww     , Gg     , Gg     , Gg     , Gg     , Gg     , Gg     , Gg     , Gg^Ve    , Gg     , Gg     , Re     , Gg     , Gg     , Gg     
Re     , Re     , Re     , Re     , Gg     , Gg     , Re     , Re     , Gg     , Gg     , Ww     , Ww     , Ww     , Ww     , Ww     , Ww     , Ww     , Ww     , Ww     , Wo     , Ww     , Wo     , Ww^Bw\   , Ww^Bw\   , Ww     , Wo     , Ww     , Ww     , Ww     , Wo     , Ww     , Ww     , Ww     , Ww     , Ww     , Gg     , Gg     , Gg     , Gg     , Gg     , Gg     , Gg     , Gg     , Gg     , Gg     , Gg     , Re     , Gg     , Gg     , Gg     
Gg     , Gg     , Re     , Gg     , Gg     , Gg     , Gg     , Re     , Gg     , Gg     , Gg     , Ww     , Wo     , Wo     , Wo     , Wo     , Wo     , Wo     , Wo     , Wo     , Wo     , Wo     , Wo     , Wo     , Ww^Bw\   , Wo^Bw\   , Wo     , Wo     , Wo     , Wo     , Wo     , Wo     , Wo     , Ww     , Ww     , Ww     , Gg     , Gg     , Gg     , Gg     , Gg     , Gg     , Gg     , Gg     , Gg     , Gg     , Re     , Gg     , Gg     , Gg     
Gg     , Gg     , Gg     , Gg     , Gg     , Gg     , Gg     , Re     , Gg     , Ww     , Ww     , Ww     , Wo     , Wo     , Wo     , Wo     , Wo     , Wo     , Wo     , Wo     , Wo     , Wo     , Wo     , Wo     , Wo     , Wo     , Wo^Bw\   , Wo^Bw\   , Wo     , Ww^Vm    , Wo     , Wo     , Wo     , Wo     , Ww     , Ww     , Ww     , Gg     , Gg     , Gg     , Gg     , Gg     , Gg     , Gg     , Gg     , Gg     , Re     , Re     , Gg     , Gg     
Gg     , Gg     , Gg     , Gg     , Gg     , Gg     , Gg     , Re     , Gg     , Gg     , Ww     , Ww     , Wo     , Wo     , Wo     , Wo     , Wo     , Wo     , Wo     , Wo     , Wo     , Wo     , Wo     , Wo     , Wo     , Wo     , Wo     , Wo     , Wo^Bw\   , Wo^Bw\   , Wo     , Wo     , Wo     , Ww     , Ww     , Ww     , Ww     , Ww     , Gg     , Gg     , Gg     , Gg     , Gg     , Gg     , Gg     , Gg     , Gg     , Gg     , Re     , Gg     
Gg     , Gg     , Gg     , Gg     , Gg     , Gg     , Gg     , Gg     , Re     , Gg     , Ww     , Ww     , Ww     , Wo     , Wo     , Wo     , Wo     , Wo     , Wo     , Wo     , Wo     , Wo     , Wo     , Wo     , Wo     , Wo     , Wo     , Wo     , Wo     , Wo     , Wo^Bw\   , Wo^Bw\   , Wo     , Ww     , Ww     , Ww     , Ww     , Ww     , Ww     , Gg     , Gg     , Gg     , Gg     , Gg     , Gg     , Gg     , Gg     , Gg     , Re     , Gg     
Gg     , Gg     , Gg     , Gg     , Gg     , Gg     , Gg^Ve    , Gg     , Re     , Gg     , Ww     , Ww     , Wo     , Wo     , Wo     , Wo     , Wo     , Wo     , Wo     , Ww^Vm    , Wo     , Wo     , Wo     , Wo     , Wo     , Wo     , Wo     , Wo     , Wo     , Wo     , Wo     , Wo     , Ww^Bw\   , Ww^Bw\   , Ww     , Ww     , Ww     , Ww     , Ww     , Gg     , Gg     , Ww     , Gg     , Gg     , Gg     , Gg^Ve    , Gg     , Gg     , Re     , Gg     
Gg     , Gg     , Gg     , Gg     , Gg     , Gg     , Gg     , Gg     , Re     , Ch     , Gg     , Wo     , Wo     , Wo     , Wo     , Wo     , Wo     , Wo     , Wo     , Wo     , Wo     , Wo     , Wo     , Wo     , Wo     , Wo     , Wo     , Wo     , Wo     , Wo     , Wo     , Wo     , Ww     , Ww     , Ww^Bw\   , Ww^Bw\   , Ww     , Ww     , Ww     , Ww     , Ww     , Ww     , Gg     , Gg     , Gg     , Gg     , Gg     , Gg     , Re     , Gg     
Gg     , Gg     , Gg     , Gg     , Gg     , Gg     , Gg     , Gg     , 3 Kh   , Ch     , Ww     , Ww     , Wo     , Wo     , Wo     , Wo     , Wo     , Wo     , Wo     , Wo     , Wo     , Wo     , Wo     , Wo     , Wo     , Wo     , Wo     , Wo     , Wo     , Wo     , Wo     , Wo     , Wo     , Ww     , Ww     , Ww     , Ww^Bw\   , Ww^Bw\   , Ww     , Ww     , Ww     , Ww     , Gg     , Gg     , Gg     , Gg     , Gg     , Gg     , Re     , Gg     
Gg     , Gg     , Gg     , Gg     , Gg     , Gg     , Gg     , Gg     , Ch     , Ch     , Ww     , Ww     , Wo     , Wo     , Wo     , Wo     , Wo     , Wo     , Wo     , Wo     , Wo     , Wo     , Wo     , Wo     , Wo     , Wo     , Wo     , Wo     , Wo     , Wo     , Wo     , Wo     , Wo     , Wo     , Ww     , Ww     , Ww     , Ww^Vm    , Ww^Bw\   , Ww^Bw\   , Ww     , Ww     , Ww     , Ww     , Gg     , Gg     , Gg     , Gg     , Re     , Gg     
Gg     , Gg     , Gg^Ve    , Gg     , Gg     , Gg     , Gg     , Gg     , Gg     , Gg     , Ww     , Ww     , Ww     , Ww     , Wo     , Wo     , Wo     , Wo     , Wo     , Wo     , Wo     , Wo     , Wo     , Wo     , Wo     , Wo     , Wo     , Wo     , Wo     , Wo     , Wo     , Wo     , Wo     , Wo     , Wo     , Wo     , Ww     , Ww     , Ww     , Ww     , Ww^Bw\   , Ww^Bw\   , Ww     , Ww     , Gg     , Gg     , Gg     , Re     , Re     , Gg     
Gg     , Gg     , Gg     , Gg     , Gg     , Gg     , Gg     , Gg     , Gg     , Gg     , Ww     , Ww     , Wo     , Wo     , Wo     , Wo     , Wo     , Wo     , Wo     , Wo     , Wo     , Wo     , Wo     , Wo     , Wo     , Wo     , Wo     , Wo     , Wo     , Wo     , Wo     , Wo     , Wo     , Wo     , Wo     , Wo     , Ww     , Ww     , Ww     , Ww     , Ww     , Ww     , Ww^Bw\   , Ww^Bw\   , Gg     , Gg     , Gg     , Re     , Gg     , Gg     
Gg     , Gg     , Gg     , Gg     , Gg     , Gg     , Gg     , Gg     , Gg     , Gg     , Gg     , Ww     , Wo     , Wo     , Wo     , Wo     , Wo     , Ww^Vm    , Wo     , Wo     , Wo     , Wo     , Wo     , Wo     , Wo     , Wo     , Wo     , Wo     , Wo     , Wo     , Wo     , Wo     , Wo     , Wo     , Wo     , Wo     , Wo     , Wo     , Ww     , Ww     , Ww     , Ww     , Ww     , Ww     , Ww^Bw\   , Ww^Bw\   , Ch     , Ch     , Gg     , Gg     
Gg     , Gg     , Gg     , Gg     , Gg     , Gg     , Gg     , Gg     , Gg     , Gg     , Gg     , Ww     , Wo     , Wo     , Wo     , Wo     , Wo     , Wo     , Wo     , Wo     , Wo     , Wo     , Wo     , Wo     , Wo     , Wo     , Wo     , Wo     , Wo     , Wo     , Wo     , Wo     , Wo     , Wo     , Wo     , Wo     , Wo     , Wo     , Ww     , Wo     , Ww     , Wo     , Ww     , Ww     , Ww     , Ch     , 1 Kh   , Ch     , Gg^Ve    , Gg     
Gg     , Gg     , Gg     , Gg     , Gg     , Gg     , Gg     , Gg     , Gg     , Ww     , Ww     , Ww     , Wo     , Wo     , Wo     , Wo     , Wo     , Wo     , Wo     , Wo     , Wo     , Wo     , Wo     , Wo     , Wo     , Wo     , Wo     , Wo     , Wo     , Wo     , Wo     , Wo     , Wo     , Wo     , Wo     , Wo     , Wo     , Wo     , Wo     , Wo     , Wo     , Wo     , Ww     , Ww     , Ww     , Ww     , Ch     , Gg     , Gg     , Gg     
Gg     , Gg     , Gg     , Gg     , Gg     , Gg     , Gg     , Gg     , Gg     , Gg     , Ww     , Ww     , Wo     , Wo     , Wo     , Wo     , Wo     , Wo     , Wo     , Wo     , Wo     , Wo     , Wo     , Wo     , Wo     , Wo     , Wo     , Wo     , Wo     , Wo     , Wo     , Wo     , Wo     , Wo     , Wo     , Wo     , Wo     , Wo     , Wo     , Wo     , Wo     , Ww     , Ww     , Ww     , Ww     , Ww     , Gg     , Gg     , Gg     , Gg     
