    Mm,    Mm,    Mm,    Mm,    Mm,    Mm,    Mm,    Mm,    Mm,    Mm,    Mm,    Mm,    Mm,    Mm,    Mm,    Mm,    Mm,    Mm,    Mm,    Mm,    Mm,    Mm,    Mm,    Mm,    Mm,    Mm,    Mm,    Mm,    Hh,    Gg,    Gg,    Gg,    Gg,    Gg,    Gg,    Gg,    Gg,    Gg,    Gg,    Gg,    Gg,    Gg,    Gg,    Gg,    Gg
    Mm,    Mm,    Mm,    Mm,    Mm,    Mm,    Mm,    Mm,    Mm,    Mm,    Mm,    Mm,    Mm,    Mm,    Mm,    Mm,    Mm,    Mm,    Mm,    Mm,    Mm,    Mm,    Mm,    Mm,    Mm,    Mm,    Mm,    Mm,    Hh,    Gg,    Gg,    Gg,    Gg,    Gg,    Gg,    Gg,    Gg,    Gg,    Gg,    Gg,    Gg,    Gg,    Gg,    Gg,    Gg
    Mm,    Mm,    Mm,    Mm,    Mm,    Hh,    Mm,    Hh,    Mm,    Hh,    Hh,    Mm,    Mm,    Mm,    Mm,    Hh,    Mm,    Mm,    Mm,    Mm,    Mm,    Mm,    Mm,    Mm,    Mm,    Mm,    Mm,    Hh,    Hh,    Gg,    Gg,    Gg,   Gg^Ve,    Gg,    Gg,    Gg,    Gg,    Gg,    Gg,    Gg,    Gg,    Gg,    Gg,    Gg,    Gg
    Mm,    Mm,    Mm,    Mm,    Mm,    Hh,    Hh,    Gg,    Hh,    Gg,    Hh,    Hh,    Hh,    Hh,    Hh,    Gg,    Hh,    Hh,    Mm,    Hh,    Mm,    Mm,    Hh,    Hh,    Mm,    Hh,    Mm,    Hh,    Gg,    Gg,    Gg,    Gg,    Gg,    Gg,    Gg,    Gg,    Gg,    Gg,    Gg,    Gg,    Gg,    Gg,    Gg,    Gg,    Gg
    Mm,    Mm,    Mm,    Mm,    Mm,    Hh,    Gg,    Gg,    Gg,    Gg,    Gg,    Gg,    Hh,    Hh,    Gg,    Gg,    Gg,    Gg,    Hh,    Gg,    Hh,    Mm,    Hh,    Gg,    Hh,    Gg,    Hh,    Hh,    Gg,    Gg,    Gg,    Gg,    Gg,    Gg,    Gg,    Gg,    Gg,    Gg,    Gg,    Gg,    Gg,    Gg,    Gg,    Gg,    Gg
    Mm,    Mm,    Mm,    Hh,    Hh,    Gg,    Gg,    Gg,    Gg,    Gg,    Gg,    Gg,    Gg,    Gg,    Gg,    Gg,    Gg,    Gg,    Hh,    Gg,    Hh,    Hh,    Hh,    Gg,    Gg,    Gg,    Gg,    Hh,    Hh,    Gg,    Gg,    Gg,    Gg,    Gg,    Gg,    Gg,    Gg,    Ch,    Gg,    Gg,    Gg,    Gg,    Gg,    Gg,    Gg
    Mm,    Mm,    Hh,    Hh,    Gg,    Gg,    Gg,    Gg,    Gg,    Gg,    Gg,    Gg,    Gg,    Gg,    Gg,    Gg,    Gg,    Gg,    Gg,    Gg,    Gg,    Gg,    Gg,    Gg,    Gg,    Gg,    Gg,    Gg,    Gg,    Gg,    Gg,    Gg,    Gg,    Gg,    Gg,    Gg,    Ch,  2 Kh,    Ch,    Gg,    Gg,    Gg,    Gg,    Gg,    Gg
    Mm,    Hh,    Hh,    Gg,    Gg,    Gg,    Gg,    Gg,    Gg,    Gg,    Gg,    Gg,    Gg,    Gg,    Gg,    Gg,    Gg,    Gg,    Gg,    Gg,    Gg,    Gg,    Gg,    Gg,    Gg,    Gg,    Gg,    Gg,    Gg,    Gg,    Gg,    Gg,    Gg,    Gg,    Gg,    Gg,    Ch,    Ch,    Ch,    Gg,    Gg,    Gg,    Gg,    Gg,    Gg
    Hh,    Gg,    Gg,    Gg,    Gg,    Gg,    Gg,    Gg,    Gg,    Gg,    Gg,    Gg,    Gg,    Gg,    Gg,    Gg,    Gg,    Gg,    Gg,    Gg,    Gg,    Gg,    Gg,    Gg,    Gg,    Gg,    Gg,    Gg,    Gg,    Gg,    Gg,    Gg,    Gg,    Gg,    Gg,    Gg,    Gg,    Gg,    Gg,    Gg,    Gg,    Gg,    Gg,    Gg,    Gg
    Gg,    Gg,    Gg,    Gg,    Gg,    Gg,    Gg,    Gg,    Gg,    Gg,    Gg,    Gg,    Gg,    Gg,    Gg,    Gg,    Gg,    Gg,    Gg,    Gg,    Gg,    Gg,    Gg,    Gg,    Gg,    Gg,    Gg,    Gg,    Gg,    Gg,    Gg,    Gg,    Gg,    Gg,    Gg,    Gg,    Gg,    Gg,    Gg,    Gg,    Gg,    Gg,    Gg,    Gg,    Gg
    Gg,    Gg,    Gg,    Gg,    Gg,    Gg,    Gg,    Gg,    Gg,    Gg,    Gg,    Gg,    Gg,    Gg,    Gg,    Gg,    Gg,    Gg,    Gg,    Gg,    Gg,    Gg,    Gg,    Gg,    Gg,   Gg^Ve,    Gg,    Gg,    Gg,    Gg,    Gg,    Gg,    Gg,    Gg,    Gg,    Gg,    Gg,    Gg,    Gg,    Gg,    Gg,    Gg,    Gg,    Gg,    Gg
    Gg,    Gg,    Gg,    Gg,    Gg,    Gg,    Gg,    Gg,    Gg,    Gg,    Gg,    Gg,    Gg,    Gg,    Gg,    Gg,    Gg,    Gg,    Gg,    Gg,    Gg,    Gg,    Gg,    Gg,    Gg,    Gg,    Gg,    Gg,    Gg,    Gg,    Gg,    Gg,    Gg,    Gg,    Gg,    Gg,    Gg,    Gg,    Gg,    Gg,    Gg,    Gg,    Gg,    Gg,    Gg
    Gg,    Gg,    Gg,    Gg,    Gg,    Gg,    Gg,    Gg,    Gg,    Gg,    Gg,    Gg,    Gg,    Gg,    Gg,    Gg,    Gg,    Gg,    Gg,    Gg,    Gg,    Gg,    Gg,    Gg,    Gg,    Gg,    Gg,    Gg,    Gg,    Gg,    Gg,    Gg,    Gg,    Gg,    Gg,    Gg,    Gg,    Gg,    Gg,    Gg,    Gg,    Gg,    Gg,    Gg,    Gg
    Gg,    Gg,    Gg,    Gg,    Gg,    Gg,    Gg,    Gg,    Gg,    Gg,    Gg,    Gg,   Gg^Ve,    Gg,    Gg,    Gg,    Gg,    Gg,    Gg,    Gg,    Gg,    Gg,    Gg,    Gg,    Gg,    Gg,    Gg,    Gg,    Gg,    Gg,    Gg,    Gg,    Gg,    Gg,    Gg,    Gg,    Gg,    Gg,    Gg,    Gg,    Gg,    Gg,    Gg,    Gg,    Gg
    Gg,    Gg,    Gg,    Gg,    Gg,    Gg,    Gg,    Gg,    Gg,    Gg,    Gg,    Gg,    Gg,    Gg,    Gg,    Gg,    Gg,    Gg,    Gg,    Gg,    Gg,    Gg,    Gg,    Gg,    Gg,    Gg,    Gg,    Gg,    Gg,    Gg,    Gg,    Gg,    Gg,    Gg,    Gg,    Gg,    Gg,    Gg,   Gg^Ve,    Gg,    Gg,    Gg,    Gg,    Gg,    Gg
    Gg,    Gg,    Gg,    Gg,    Gg,    Gg,    Gg,    Gg,    Gg,    Gg,    Gg,    Gg,    Gg,    Gg,    Gg,    Gg,    Gg,    Gg,    Gg,    Gg,    Gg,    Gg,    Gg,    Gg,    Gg,    Gg,    Gg,    Gg,    Gg,    Gg,    Gg,    Gg,    Gg,    Gg,    Gg,    Gg,    Gg,    Gg,    Gg,    Gg,    Gg,    Gg,    Gg,    Gg,    Gg
    Gg,    Gg,    Gg,    Gg,    Gg,    Gg,    Gg,    Gg,    Gg,    Gg,    Gg,    Gg,    Gg,    Gg,    Gg,    Gg,    Gg,    Gg,    Gg,    Gg,    Gg,    Gg,    Gg,    Gg,    Gg,    Gg,    Gg,    Gg,    Gg,    Gg,    Gg,    Gg,    Gg,    Gg,    Gg,    Gg,    Gg,    Gg,    Gg,    Gg,    Gg,    Gg,    Gg,    Gg,    Gg
    Gg,    Gg,    Gg,    Gg,    Gg,    Gg,    Gg,    Gg,    Gg,    Gg,    Gg,    Gg,    Gg,    Gg,    Gg,    Gg,    Gg,    Gg,    Gg,    Gg,    Gg,    Gg,    Gg,    Gg,    Gg,    Gg,    Gg,    Gg,    Gg,    Gg,    Gg,    Gg,    Gg,    Gg,    Gg,    Gg,    Gg,    Gg,    Gg,    Gg,    Gg,    Gg,    Gg,    Gg,    Gg
    Gg,    Gg,    Gg,    Gg,    Gg,    Gg,    Gg,    Gg,    Gg,    Gg,    Gg,    Gg,    Gg,    Gg,    Gg,    Gg,    Gg,    Gg,    Gg,    Gg,    Gg,    Gg,    Gg,    Gg,    Gg,    Gg,    Gg,    Gg,    Gg,    Gg,    Gg,    Gg,    Gg,    Gg,    Gg,    Gg,    Gg,    Gg,    Gg,    Gg,    Gg,    Gg,    Gg,    Gg,    Gg
    Gg,    Gg,    Gg,    Gg,    Gg,    Gg,    Gg,    Gg,    Gg,    Gg,    Gg,    Gg,    Gg,    Gg,    Gg,    Gg,    Gg,    Gg,    Gg,    Gg,    Gg,    Gg,    Gg,    Gg,    Gg,    Gg,    Gg,    Gg,    Gg,    Gg,    Gg,    Gg,    Gg,    Gg,    Gg,    Gg,    Gg,    Gg,    Gg,    Gg,    Gg,    Gg,    Gg,    Gg,    Gg
    Gg,    Gg,    Gg,    Gg,    Gg,    Gg,    Gg,    Gg,    Gg,    Gg,    Gg,    Gg,    Gg,    Gg,    Gg,    Gg,    Gg,    Gg,    Gg,    Gg,    Gg,    Gg,    Gg,    Gg,    Gg,   Chr,   Chr,   Chr,    Gg,    Gg,    Gg,    Gg,    Gg,    Gg,    Gg,    Gg,    Gg,    Gg,    Gg,    Gg,    Gg,    Gg,    Gg,    Gg,    Gg
    Gg,    Gg,    Gg,    Gg,    Gg,    Gg,    Gg,    Gg,    Gg,    Gg,    Gg,    Gg,    Gg,    Gg,    Gg,    Gg,    Gg,    Gg,    Gg,    Gg,    Gg,    Gg,    Gg,    Gg,    Gg,   Chr,    Khr,   Chr,    Gg,    Gg,    Gg,    Gg,    Gg,    Gg,    Gg,    Gg,    Gg,    Gg,    Gg,    Gg,    Gg,    Gg,    Gg,    Gg,    Gg
    Gg,    Gg,    Gg,    Gg,    Gg,    Gg,    Gg,    Gg,    Gg,    Gg,    Gg,    Gg,    Gg,    Gg,    Gg,    Gg,    Gg,    Gg,    Gg,    Gg,    Gg,    Gg,    Gg,    Gg,    Gg,    Gg,   Chr,    Gg,    Gg,    Gg,    Gg,    Gg,    Gg,    Gg,    Gg,    Gg,    Gg,    Gg,    Gg,    Gg,    Gg,    Gg,    Gg,    Gg,    Gg
    Gg,    Gg,    Gg,    Gg,    Gg,    Gg,    Gg,    Gg,   Gg^Ve,    Gg,    Ce,    Ce,    Ce,    Gg,    Gg,    Gg,    Gg,    Gg,    Gg,    Gg,    Gg,    Gg,    Gg,    Gg,    Gg,    Gg,    Gg,    Gg,    Gg,    Gg,    Gg,    Gg,    Gg,    Gg,    Gg,    Gg,    Gg,    Gg,    Gg,    Gg,    Gg,    Gg,    Gg,    Gg,    Gg
    Gg,    Gg,    Gg,    Gg,    Gg,    Gg,    Gg,    Gg,    Gg,    Gg,    Ce,  1 Ke,    Ce,    Gg,    Gg,    Gg,    Gg,    Gg,    Gg,    Gg,    Gg,    Gg,    Gg,    Gg,    Gg,    Gg,    Gg,    Gg,    Gg,    Gg,    Gg,    Gg,    Gg,    Gg,    Gg,    Gg,    Gg,    Gg,    Gg,    Gg,    Gg,    Gg,    Gg,    Gg,    Gg
    Gg,    Gg,    Gg,    Gg,    Gg,    Gg,    Gg,    Gg,    Gg,    Gg,    Gg,    Ce,    Gg,    Gg,    Gg,    Gg,    Gg,    Gg,    Gg,    Gg,    Gg,    Gg,    Gg,    Gg,    Gg,    Gg,    Gg,    Gg,    Gg,    Gg,    Gg,    Gg,    Gg,    Gg,    Gg,    Gg,    Gg,    Gg,    Gg,    Gg,    Gg,    Gg,    Gg,    Gg,    Gg
    Gg,    Gg,    Gg,    Gg,    Gg,    Gg,    Gg,    Gg,    Gg,    Gg,    Gg,    Gg,    Gg,    Gg,    Gg,    Gg,    Gg,    Gg,    Gg,    Gg,    Gg,    Gg,    Gg,    Gg,    Gg,    Gg,    Gg,    Gg,    Gg,    Gg,    Gg,    Gg,    Gg,    Gg,    Gg,    Gg,   Gg^Ve,    Gg,    Gg,    Gg,    Gg,    Gg,    Gg,    Gg,    Gg
    Gg,    Gg,    Gg,    Gg,    Gg,    Gg,    Gg,    Gg,    Gg,    Gg,    Gg,    Gg,    Gg,    Gg,    Gg,    Gg,    Gg,    Gg,    Gg,    Gg,    Gg,    Gg,    Gg,    Gg,    Gg,    Gg,    Gg,    Gg,    Gg,    Gg,    Gg,    Gg,    Gg,    Gg,    Gg,    Gg,    Gg,    Gg,    Gg,    Gg,    Gg,    Gg,    Gg,    Gg,    Gg
    Gg,    Gg,    Gg,    Gg,    Gg,    Gg,    Gg,    Gg,    Gg,    Gg,    Gg,    Gg,    Gg,    Gg,    Gg,    Gg,    Gg,    Gg,    Gg,    Gg,    Gg,    Gg,    Gg,    Gg,    Gg,    Gg,    Gg,    Gg,    Gg,    Gg,    Gg,    Gg,    Gg,    Gg,    Gg,    Gg,    Gg,    Gg,    Gg,    Gg,    Gg,    Gg,    Gg,    Gg,    Gg
    Gg,    Gg,    Gg,    Gg,    Gg,    Gg,    Gg,    Gg,    Gg,    Gg,    Gg,    Gg,    Gg,    Gg,    Gg,    Gg,    Gg,    Gg,    Gg,    Gg,    Gg,    Gg,    Gg,    Gg,    Gg,    Gg,    Gg,    Gg,    Gg,    Gg,    Gg,    Gg,    Gg,    Gg,    Gg,    Gg,    Gg,    Gg,    Gg,    Gg,    Gg,    Gg,    Gg,    Gg,    Gg

