    Wo,    Wo,    Wo,    Wo,    Wo,    Wo,    Wo,    Wo,    Wo,    Wo,    Wo,    Wo,    Wo,    Wo,    Wo,    Wo,    Wo,    Wo,    Wo,    Wo,    Wo,    Wo,    Wo,    Wo,    Wo,    Wo,    Wo,    Wo,    Wo,    Wo
    Wo,    Wo,    Wo,    Wo,    Wo,    Wo,    Wo,    Wo,    Wo,    Wo,    Wo,    Wo,    Wo,   Chw,   Chw,   Chw,    Wo,    Wo,    Wo,    Wo,    Wo,    Wo,    Wo,    Wo,    Wo,    Wo,    Wo,    Wo,    Wo,    Wo
    Wo,    Wo,    Wo,    Wo,    Wo,    Wo,    Wo,    Wo,    Wo,    Wo,    Wo,    Wo,    Wo,   Chw,  1 Khw,   Chw,    Wo,    Wo,    Wo,    Wo,    Wo,    Wo,    Wo,    Wo,    Wo,    Wo,    Wo,    Wo,    Wo,    Wo
    Wo,    Wo,    Wo,    Wo,    Wo,    Wo,    Wo,    Wo,    Wo,    Wo,    Wo,    Wo,    Wo,    Wo,   Chw,    Wo,    Wo,    Wo,    Wo,    Wo,    Wo,    Wo,    Wo,    Wo,    Wo,    Wo,    Wo,    Wo,    Wo,    Wo
    Wo,    Wo,    Wo,    Wo,    Wo,    Wo,    Wo,    Wo,    Wo,    Wo,    Wo,    Wo,    Wo,    Wo,    Wo,    Wo,    Wo,    Wo,    Wo,    Wo,    Wo,    Wo,    Wo,    Wo,    Wo,    Wo,    Wo,    Wo,    Wo,    Wo
    Wo,    Wo,    Wo,    Wo,    Wo,    Wo,    Wo,    Wo,    Wo,    Wo,    Wo,    Wo,    Wo,    Wo,    Wo,    Wo,    Wo,    Wo,    Wo,    Wo,    Wo,    Wo,    Wo,    Wo,    Wo,    Wo,    Wo,    Wo,    Wo,    Wo
    Wo,    Wo,    Wo,    Wo,    Wo,    Wo,    Wo,    Wo,    Wo,    Wo,    Wo,    Wo,    Wo,    Wo,    Wo,    Wo,    Wo,    Wo,    Wo,    Wo,    Wo,    Wo,    Wo,    Wo,    Wo,    Wo,    Wo,    Wo,    Wo,    Wo
    Wo,    Wo,    Wo,    Wo,    Wo,    Wo,    Wo,    Wo,    Wo,    Wo,    Wo,    Wo,    Wo,    Wo,    Wo,    Wo,    Wo,    Wo,    Wo,    Wo,    Wo,    Wo,    Wo,    Wo,    Wo,    Wo,    Wo,    Wo,    Wo,    Wo
    Wo,    Wo,    Wo,    Wo,    Wo,    Wo,    Wo,    Wo,    Wo,    Wo,    Wo,   Ww^Vm,    Wo,    Wo,    Wo,    Wo,    Wo,    Wo,    Wo,    Wo,    Wo,    Wo,    Wo,    Wo,    Wo,    Wo,    Wo,    Wo,    Wo,    Wo
    Wo,    Wo,    Wo,    Wo,    Wo,    Wo,    Wo,    Wo,    Wo,    Wo,    Wo,    Wo,    Wo,    Wo,    Wo,    Wo,    Wo,    Wo,    Wo,    Wo,    Wo,    Wo,    Wo,    Wo,    Wo,    Wo,    Wo,    Wo,    Wo,    Wo
    Wo,    Wo,    Wo,    Wo,    Wo,    Wo,    Wo,    Wo,    Wo,    Wo,    Wo,    Wo,    Wo,    Wo,    Wo,    Wo,    Wo,    Wo,    Wo,    Wo,    Wo,    Wo,    Wo,    Wo,    Wo,    Wo,    Wo,    Wo,    Wo,    Wo
    Wo,    Wo,    Wo,    Wo,    Wo,    Wo,    Wo,    Wo,    Wo,    Wo,    Wo,    Wo,    Wo,    Wo,    Wo,    Wo,    Wo,    Wo,    Wo,    Wo,    Wo,    Wo,   Ww^Vm,    Wo,    Wo,    Wo,    Wo,    Wo,    Wo,    Wo
    Wo,    Wo,    Wo,    Wo,    Wo,    Wo,    Wo,    Wo,    Wo,    Wo,    Wo,    Wo,    Wo,    Wo,    Wo,    Wo,    Wo,    Wo,    Wo,    Wo,    Wo,    Wo,    Wo,    Wo,    Wo,    Wo,    Wo,    Wo,    Wo,    Wo
    Wo,    Wo,    Wo,    Wo,    Wo,    Wo,    Wo,    Wo,    Wo,    Wo,    Wo,    Wo,    Wo,    Wo,    Wo,   Ww^Vm,    Wo,    Wo,    Wo,    Wo,    Wo,    Wo,    Wo,    Wo,    Wo,    Wo,    Wo,    Wo,    Wo,    Wo
    Wo,    Wo,    Wo,    Wo,    Wo,    Wo,    Wo,    Wo,    Wo,    Wo,    Wo,    Wo,    Wo,    Wo,    Wo,    Wo,    Wo,    Wo,    Wo,    Wo,    Wo,    Wo,    Wo,    Wo,    Wo,    Wo,    Wo,    Wo,    Wo,    Wo
    Wo,    Wo,   Ww^Vm,    Wo,    Wo,    Wo,    Wo,    Wo,    Wo,    Wo,    Wo,    Wo,    Wo,    Ww,    Wo,    Wo,    Wo,    Wo,    Wo,    Wo,    Wo,    Wo,    Wo,    Wo,    Wo,    Wo,    Wo,    Wo,    Wo,    Wo
    Wo,    Wo,    Wo,    Wo,    Wo,    Wo,    Wo,    Wo,    Wo,    Wo,    Wo,    Ww,    Ww,    Gg,    Wo,    Wo,    Wo,    Wo,    Wo,    Wo,    Wo,    Wo,    Wo,    Wo,    Wo,    Wo,    Wo,    Wo,    Wo,    Wo
    Wo,    Wo,    Wo,    Wo,    Wo,    Wo,    Wo,    Wo,    Wo,    Wo,    Wo,  Ww^Bw\,    Gg,    Gg,    Ww,    Wo,    Wo,    Wo,    Wo,    Wo,    Wo,    Wo,    Wo,    Wo,    Wo,    Wo,    Wo,    Wo,    Wo,    Wo
    Wo,    Wo,    Wo,    Wo,    Wo,    Wo,    Wo,    Wo,    Wo,    Wo,    Ww,    Gg,   Gg^Vh,    Gg,    Gg,    Wo,    Wo,    Wo,    Wo,    Wo,    Wo,    Wo,    Wo,    Wo,    Wo,    Wo,    Wo,    Wo,    Wo,    Wo
    Wo,    Wo,    Wo,    Wo,    Wo,    Wo,    Wo,    Wo,    Wo,    Wo,    Ww,    Wo,    Ww,    Ww,    Ww,    Wo,    Wo,    Wo,    Wo,    Wo,    Wo,    Wo,    Wo,   Ww^Vm,    Wo,    Wo,    Wo,    Wo,    Wo,    Wo
    Wo,    Wo,    Wo,    Wo,    Wo,    Wo,    Wo,    Wo,   Ww^Vm,    Wo,    Wo,    Wo,    Ww,    Wo,    Wo,    Wo,    Wo,    Wo,    Wo,    Wo,    Wo,    Wo,    Wo,    Wo,    Wo,    Wo,    Wo,    Wo,    Wo,    Wo
    Wo,    Wo,    Wo,    Wo,    Wo,    Wo,    Wo,    Wo,    Wo,    Wo,    Wo,    Wo,    Wo,    Wo,    Wo,    Wo,    Wo,    Wo,    Wo,    Wo,    Wo,    Wo,    Wo,    Wo,    Wo,    Wo,    Wo,    Wo,    Wo,    Wo
    Wo,    Wo,    Wo,    Wo,    Wo,    Wo,    Wo,    Wo,    Wo,    Wo,    Wo,    Wo,    Wo,    Wo,    Wo,    Wo,    Wo,    Wo,    Wo,    Wo,    Wo,    Wo,    Wo,    Wo,    Wo,    Wo,    Wo,    Wo,    Wo,    Wo
    Wo,    Wo,    Wo,    Wo,    Wo,    Wo,    Wo,    Wo,    Wo,    Wo,    Wo,    Wo,    Wo,    Wo,    Wo,    Wo,    Wo,    Wo,    Wo,    Wo,    Wo,    Wo,    Ww,    Ww,    Wo,    Wo,    Wo,    Wo,    Wo,    Wo
    Wo,    Wo,    Wo,    Wo,    Wo,    Wo,    Wo,    Wo,    Wo,    Wo,    Wo,    Wo,    Wo,    Wo,    Wo,    Wo,    Wo,    Wo,    Wo,    Wo,    Ww,   Chw,   Chw,   Chw,    Ww,    Wo,    Wo,    Wo,    Wo,    Wo
    Wo,    Wo,    Wo,    Wo,    Wo,    Wo,    Wo,    Wo,    Wo,    Wo,    Wo,    Wo,    Wo,   Ww^Vm,    Wo,    Wo,    Wo,    Wo,    Wo,    Wo,    Ww,   Chw,  2 Khw,   Chw,    Ww,    Ww,    Wo,    Wo,    Wo,    Wo
    Wo,    Wo,    Wo,    Wo,    Wo,    Wo,    Wo,    Wo,    Wo,    Wo,    Wo,    Wo,    Wo,    Wo,    Wo,    Wo,    Wo,    Wo,    Wo,    Wo,    Ww,    Ww,   Chw,    Ww,    Ww,    Wo,    Wo,    Wo,    Wo,    Wo
    Wo,    Wo,    Wo,    Wo,    Wo,    Wo,    Wo,    Wo,    Wo,    Wo,    Wo,    Wo,    Wo,    Wo,    Wo,    Wo,    Wo,    Wo,    Wo,    Wo,    Wo,    Wo,    Ww,    Wo,    Ww,    Wo,    Wo,    Wo,    Wo,    Wo
    Wo,    Wo,    Wo,    Wo,    Wo,    Wo,    Wo,    Wo,    Wo,    Wo,    Wo,    Wo,    Wo,    Wo,    Wo,    Wo,    Wo,    Wo,    Wo,    Wo,    Wo,    Wo,    Wo,    Wo,    Wo,    Wo,    Wo,    Wo,    Wo,    Wo
    Wo,    Wo,    Wo,    Wo,    Wo,    Wo,    Wo,    Wo,    Wo,    Wo,    Wo,    Wo,    Wo,    Wo,    Wo,    Wo,    Wo,    Wo,    Wo,    Wo,    Wo,    Wo,    Wo,    Wo,    Wo,    Wo,    Wo,    Wo,    Wo,    Wo

