Xu     , Xu     , Xu     , Xu     , Xu     , Xu     , Xu     , Xu     , Xu     , Xu     , Xu     , Xu     , Xu     , Xu     , Xu     , Xu     , Xu     , Xu     , Xu     , Xu     
Xu     , Xu     , Xu     , Xu     , Xu     , Xu     , Xu     , Xu     , Xu     , Xu     , Xu     , Xu     , Xu     , Xu     , Xu     , Xu     , Xu     , Xu     , Xu     , Xu     
Xu     , Xu     , Xu     , Xu     , Xu     , Xu     , Xu     , Xu     , Xu     , Xu     , Xu     , Xu     , Xu     , Xu     , Xu     , Xu     , Xu     , Xu     , Xu     , Xu     
Xu     , Xu     , Xu     , Xu     , Xu     , Xu     , Xu     , Xu     , Xu     , Xu     , Xu     , Xu     , Xu     , Xu     , Xu     , Xu     , Xu     , Xu     , Xu     , Xu     
Xu     , Xu     , Xu     , Xu     , Xu     , Xu     , Xu     , Xu     , Xu     , Xu     , Xu     , Xu     , Xu     , Xu     , Xu     , Xu     , Xu     , Xu     , Xu     , Xu     
Xu     , Xu     , Xu     , Xu     , Xu     , Xu     , Xu     , Xu     , Xu     , Xu     , Xu     , Xu     , Xu     , Xu     , Xu     , Xu     , Xu     , Xu     , Xu     , Xu     
Xu     , Xu     , Xu     , Xu     , Xu     , Xu     , Xu     , Xu     , Xu     , Xu     , Xu     , Xu     , Xu     , Xu     , Xu     , Xu     , Xu     , Xu     , Xu     , Xu     
Xu     , Xu     , Xu     , Xu     , Xu     , Xu     , Xu     , Xu     , Xu     , Xu     , Xu     , Xu     , Xu     , Xu     , Xu     , Xu     , Xu     , Xu     , Xu     , Xu     
Xu     , Xu     , Xu     , Xu     , Xu     , Xu     , Xu     , Rr     , 1 Kh   , Rr     , Xu     , Xu     , Xu     , Xu     , Xu     , Xu     , Xu     , Xu     , Xu     , Xu     
Xu     , Xu     , Xu     , Xu     , Xu     , Xu     , Xu     , Rr     , Rr     , Rr     , Xu     , Xu     , Xu     , Xu     , Xu     , Xu     , Xu     , Xu     , Xu     , Xu     
Xu     , Xu     , Xu     , Xu     , Xu     , Xu     , Xu     , Rr     , Rr     , Rr     , Xu     , Xu     , Xu     , Xu     , Xu     , Xu     , Xu     , Xu     , Xu     , Xu     
Xu     , Xu     , Xu     , Xu     , Xu     , Xu     , Xu     , Rr     , Rr     , Rr     , Xu     , Xu     , Xu     , Xu     , Xu     , Xu     , Xu     , Xu     , Xu     , Xu     
Xu     , Xu     , Xu     , Xu     , Xu     , Xu     , Xu     , Rr     , Rr     , Rr     , Xu     , Xu     , Xu     , Xu     , Xu     , Xu     , Xu     , Xu     , Xu     , Xu     
Xu     , Xu     , Xu     , Xu     , Xu     , Xu     , Xu     , Rr     , Rr     , Rr     , Xu     , Xu     , Xu     , Xu     , Xu     , Xu     , Xu     , Xu     , Xu     , Xu     
Xu     , Xu     , Xu     , Xu     , Xu     , Xu     , Xu     , Rr     , Rr     , Rr     , Xu     , Xu     , Xu     , Xu     , Xu     , Xu     , Xu     , Xu     , Xu     , Xu     
Xu     , Xu     , Xu     , Xu     , Xu     , Xu     , Xu     , Rr     , Rr     , Rr     , Xu     , Xu     , Xu     , Xu     , Xu     , Xu     , Xu     , Xu     , Xu     , Xu     
Xu     , Xu     , Xu     , Xu     , Xu     , Xu     , Xu     , Rr     , Rr     , Rr     , Xu     , Xu     , Xu     , Xu     , Xu     , Xu     , Xu     , Xu     , Xu     , Xu     
Xu     , Xu     , Xu     , Xu     , Xu     , Xu     , Xu     , Rr     , Rr     , Rr     , Xu     , Xu     , Xu     , Xu     , Xu     , Xu     , Xu     , Xu     , Xu     , Xu     
Xu     , Xu     , Xu     , Xu     , Xu     , Xu     , Xu     , Rr     , Rr     , Rr     , Xu     , Xu     , Xu     , Xu     , Xu     , Xu     , Xu     , Xu     , Xu     , Xu     
Xu     , Xu     , Xu     , Xu     , Xu     , Xu     , Xu     , Rr     , Rr     , Rr     , Xu     , Xu     , Xu     , Xu     , Xu     , Xu     , Xu     , Xu     , Xu     , Xu     
Xu     , Xu     , Xu     , Xu     , Xu     , Xu     , Xu     , Rr     , Rr     , Rr     , Xu     , Xu     , Xu     , Xu     , Xu     , Xu     , Xu     , Xu     , Xu     , Xu     
Xu     , Xu     , Xu     , Xu     , Xu     , Xu     , Xu     , Rr     , Rr     , Rr     , Xu     , Xu     , Xu     , Xu     , Xu     , Xu     , Xu     , Xu     , Xu     , Xu     
Xu     , Xu     , Xu     , Xu     , Xu     , Xu     , Xu     , Rr     , Rr     , Rr     , Xu     , Xu     , Xu     , Xu     , Xu     , Xu     , Xu     , Xu     , Xu     , Xu     
Xu     , Xu     , Xu     , Xu     , Xu     , Xu     , Xu     , Rr     , Rr     , Rr     , Xu     , Xu     , Xu     , Xu     , Xu     , Xu     , Xu     , Xu     , Xu     , Xu     
Xu     , Xu     , Xu     , Xu     , Xu     , Xu     , Xu     , Rr     , Rr     , Rr     , Xu     , Xu     , Xu     , Xu     , Xu     , Xu     , Xu     , Xu     , Xu     , Xu     
Xu     , Xu     , Xu     , Xu     , Xu     , Xu     , Xu     , Rr     , Rr     , Rr     , Xu     , Xu     , Xu     , Xu     , Xu     , Xu     , Xu     , Xu     , Xu     , Xu     
Xu     , Xu     , Xu     , Xu     , Xu     , Xu     , Xu     , Rr     , Rr     , Rr     , Xu     , Xu     , Xu     , Xu     , Xu     , Xu     , Xu     , Xu     , Xu     , Xu     
Xu     , Xu     , Xu     , Xu     , Xu     , Xu     , Xu     , Rr     , Rr     , Rr     , Xu     , Xu     , Xu     , Xu     , Xu     , Xu     , Xu     , Xu     , Xu     , Xu     
Xu     , Xu     , Xu     , Xu     , Xu     , Xu     , Xu     , Rr     , Rr     , Rr     , Xu     , Xu     , Xu     , Xu     , Xu     , Xu     , Xu     , Xu     , Xu     , Xu     
Xu     , Xu     , Xu     , Xu     , Xu     , Xu     , Xu     , Rr     , Rr     , Rr     , Xu     , Xu     , Xu     , Xu     , Xu     , Xu     , Xu     , Xu     , Xu     , Xu     
