4 Kh   , Ch     , Ch     , Yf     , Yf     , Yf     , Yww    , Yww    , Yww    , Yww    , Yww    , Yww    , Yww    , Yww    , Yww    , Yww    , Yww    , Yww    , Yww    , Yww    , Yww    , Yww    , Yww    , Yww    , Yww    , Yww    , Yww    , Gg^Ve    , Gg^Ve    , Gg^Ve    
Ch     , Yf     , Yf     , Yf     , Yf     , Yf     , Yww    , Yww    , Yww    , Yww    , Yww    , Yww    , Yww    , Yww    , Yww    , Yww    , Yww    , Yf     , Yf     , Yf     , Yf     , Yf     , Yww    , Yww    , Yww    , Yww    , Yww    , Yww    , Yww    , Yww    
Yf     , Yf     , Yf     , Yf     , Yf     , Yf     , Yf     , Yww    , Yww    , Yww    , Yww    , Yww    , Yww    , Yww    , Yww    , Yww    , Yf     , Yf     , Yf     , Yf     , Yf     , Yf     , Yf     , Yf     , Yww    , Yww    , Yww    , Yww    , Yww    , Yww    
Yf     , Yf     , Yf     , Yf     , Yf     , Yf     , Yf     , Yf     , Yww    , Yf     , Yww    , Yf     , Yww    , Yf     , Yww    , Yww    , Yf     , Yf     , Yf     , Yf     , Yf     , Yf     , Yf     , Yf     , Yww    , Yww    , Yww    , Yww    , Yww    , Yww    
Yf     , Yf     , Yf     , Yf     , Yf     , Yf     , Yf     , Yf     , Yf     , Yf     , Yf     , Yf     , Yf     , Yf     , Yf     , Yww    , Yf     , Yf     , Yf     , Yf     , Yf     , Yf     , Yf     , Yww    , Yww    , Yww    , Yww    , Yww    , Yww    , Yww    
Yww    , Yww    , Yww    , Yww    , Yf     , Yww    , Yww    , Yww    , Yf     , Yww    , Yf     , Yww    , Yf     , Yf     , Yf     , Yww    , Yww    , Yf     , Yf     , Yf     , Yf     , Yww    , Yww    , Yww    , Yww    , Yww    , Yww    , Yww    , Yww    , Yww    
Yww    , Yww    , Yww    , Yww    , Yww    , Yww    , Yww    , Yww    , Yww    , Yww    , Yww    , Yww    , Yf     , Yf     , Yf     , Yww    , Yww    , Yww    , Yf     , Yww    , Yww    , Yww    , Yww    , Yww    , Yww    , Yww    , Yww    , Yww    , Yww    , Yww    
Yww    , Yww    , Yww    , Yww    , Yww    , Yww    , Yww    , Yww    , Yww    , Yww    , Yww    , Yww    , Yww    , Yww    , Yww    , Yww    , Yww    , Yww    , Yww    , Yww    , Yww    , Yf     , Yww    , Yww    , Yww    , Yww    , Yww    , Yww    , Yww    , Yww    
Yww    , Yww    , Yww    , Yww    , Yww    , Yww    , Yww    , Yww    , Yww    , Yww    , Yww    , Yww    , Yf     , Yf     , Yf     , Yww    , Yww    , Yww    , Yww    , Yf     , Yf     , Yf     , Yww    , Yww    , Yww    , Yww    , Yww    , Yww    , Yww    , Yww    
Yww    , Yww    , Yww    , Yww    , Yww    , Yww    , Yww    , Yww    , Yww    , Yww    , Yww    , Yww    , Yf     , Yf     , Yf     , Yww    , Yww    , Yf     , Yf     , Yf     , Yf     , Yf     , Yww    , Yww    , Yww    , Yww    , Yww    , Yww    , Yww    , Yww    
Yww    , Yww    , Yww    , Yww    , Yww    , Yww    , Yww    , Yww    , Yww    , Yww    , Yww    , Yww    , Yf     , Yf     , Yf     , Yww    , Yf     , Yf     , Yf     , Yf     , Yf     , Yf     , Yww    , Yww    , Yww    , Yww    , Yww    , Yww    , Yww    , Yww    
Yww    , Yww    , Yww    , Yww    , Yww    , Yww    , Yww    , Yww    , Yww    , Yf     , Yww    , Yf     , Yf     , Yf     , Yf     , Yww    , Yf     , Yf     , Yf     , Yf     , Yf     , Yf     , Yww    , Yww    , Yww    , Yww    , Yww    , Yww    , Yww    , Yww    
Yww    , Yww    , Yww    , Yww    , Yww    , Yww    , Yww    , Yf     , Yf     , Yf     , Yf     , Yf     , Yf     , Yf     , Yf     , Yww    , Yww    , Yww    , Yf     , Yf     , Yf     , Yf     , Yww    , Yww    , Yww    , Yww    , Yww    , Yww    , Yww    , Yww    
Yww    , Yww    , Yww    , Yww    , Yww    , Yf     , Yf     , Yf     , Yf     , Yww    , Yww    , Yww    , Yf     , Yf     , Yf     , Yww    , Yww    , Yww    , Yww    , Yww    , Yww    , Yf     , Yww    , Yww    , Yww    , Yww    , Yww    , Yww    , Yww    , Yww    
Yww    , Yww    , Yww    , Yf     , Yf     , Yf     , Yf     , Yww    , Yww    , Yww    , Yww    , Yww    , Yf     , Yf     , Yf     , Yww    , Yww    , Yww    , Yww    , Yww    , Yww    , Yww    , Yf     , Yww    , Yww    , Yww    , Yww    , Yww    , Yww    , Yww    
Yww    , Yf     , Yf     , Yf     , Yf     , Yf     , Yww    , Yww    , Yww    , Yww    , Yww    , Yww    , Yf     , Yf     , Yf     , Yww    , Yww    , Yww    , Yww    , Yww    , Yww    , Yww    , Yww    , Yww    , Yww    , Yww    , Yww    , Yww    , Yww    , Yww    
Yww    , Yf     , Yf     , Yf     , Yf     , Yww    , Yww    , Yww    , Yww    , Yww    , Yww    , Yww    , Yf     , Yf     , Yf     , Yww    , Yww    , Yww    , Yww    , Yww    , Yww    , Yww    , Yww    , Yww    , Yww    , Yww    , Yww    , Yww    , Yww    , Yww    
Yww    , Yf     , Yf     , Yww    , Yww    , Yww    , Yww    , Yww    , Yww    , Yww    , Yww    , Yww    , Yf     , Yf     , Yf     , Yww    , Yww    , Yww    , Yww    , Yww    , Yww    , Yww    , Yww    , Yww    , Yww    , Yww    , Yww    , Yww    , Yww    , Yww    
Yww    , Yf     , Yf     , Yww    , Yww    , Yf     , Yf     , Yf     , Yww    , Yww    , Yww    , Yf     , Yf     , Yf     , Yf     , Yf     , Yww    , Yww    , Yww    , Yww    , Yww    , Yww    , Yww    , Yww    , Yww    , Yww    , Yww    , Yww    , Yww    , Yww    
Yww    , Yf     , Yf     , Yww    , Yf     , Yf     , Yf     , Yf     , Yf     , Yf     , Yf     , Yf     , Yf     , Yww    , Yf     , Yf     , Yf     , Yf     , Yf     , Yww    , Yf     , Yf     , Yww    , Yww    , Yww    , Yww    , Yww    , Yww    , Yww    , Yww    
Yww    , Yf     , Yf     , Yww    , Yf     , Yf     , Yf     , Yf     , Yf     , Yf     , Yf     , Yf     , Yww    , Yww    , Yww    , Yf     , Yf     , Yf     , Yf     , Yww    , Yf     , Yf     , Yf     , Yww    , Yww    , Yww    , Yww    , Yww    , Yww    , Yww    
Yww    , Yf     , Yf     , Yww    , Yf     , Yf     , Yf     , Yww    , Yf     , Yww    , Yf     , Yf     , Yf     , Yf     , Yf     , Yf     , Yww    , Yww    , Yf     , Yww    , Yf     , Yf     , Yf     , Yww    , Yww    , Yww    , Yww    , Yww    , Yww    , Yww    
Yww    , Yf     , Yf     , Yww    , Yf     , Yf     , Yww    , Yww    , Yww    , Yww    , Yww    , Yww    , Yf     , Yf     , Yf     , Yww    , Yww    , Yww    , Yww    , Yww    , Yf     , Yf     , Yf     , Yww    , Yww    , Yww    , Yww    , Yww    , Yww    , Yww    
Yww    , Yf     , Yf     , Yww    , Yf     , Yf     , Yww    , Yww    , Yww    , Yf     , Yww    , Yww    , Yf     , Yf     , Yf     , Yww    , Yww    , Yww    , Yww    , Yww    , Yf     , Yf     , Yf     , Yww    , Yww    , Yww    , Yww    , Yww    , Yww    , Yww    
Yww    , Yf     , Yf     , Yww    , Yf     , Yww    , Yww    , Yww    , Yf     , Yf     , Yww    , Yww    , Yf     , Yf     , Yf     , Yww    , Yww    , Yww    , Yww    , Yww    , Yf     , Yf     , Yf     , Yww    , Yww    , Yww    , Yww    , Yww    , Yww    , Yww    
Yww    , Ch     , Yf     , Yww    , Yww    , Yww    , Yww    , Yww    , Yf     , Yf     , Yww    , Yww    , Yf     , Yf     , Yf     , Yww    , Yww    , Yww    , Yww    , Yww    , Yf     , Yww    , Yf     , Yww    , Yww    , Yww    , Yww    , Yww    , Yww    , Yww    
Yww    , Ch     , Ch     , Ch     , Yww    , Yf     , Yww    , Yf     , Yf     , Yf     , Yww    , Yww    , Yf     , Yf     , Yf     , Yww    , Yww    , Yww    , Yww    , Yww    , Yww    , Yww    , Yww    , Yww    , Yww    , Yww    , Yww    , Yww    , Yww    , Yww    
Yww    , 3 Kh   , Ch     , Yww    , Yf     , Yf     , Yf     , Yww    , Yf     , Yf     , Yww    , Yww    , Yf     , Yf     , Yf     , Yww    , Yww    , Yww    , Yww    , Yww    , Yww    , Yww    , Yww    , Yww    , Yww    , Yww    , Yww    , Yww    , Yww    , Yww    
Yww    , Yww    , Yww    , Yww    , Yww    , Yww    , Yww    , Yww    , Yww    , Yww    , Yww    , Yww    , Ch     , Ch     , Ch     , Yww    , Yww    , Yww    , Yww    , Yww    , Yww    , Yww    , Yww    , Yww    , Yww    , Yww    , Yww    , Yww    , Yww    , Yww    
2 Kh   , Yww    , Yww    , Yww    , Yww    , Yww    , Yww    , Yww    , Yww    , Yww    , Yww    , Yww    , Ch     , 1 Kh   , Ch     , Yww    , Yww    , Yww    , Yww    , Yww    , Yww    , Yww    , Yww    , Yww    , Yww    , Yww    , Yww    , Yww    , Yww    , 5 Kh   
