Wo     , Wo     , Wo     , Wo     , Wo     , Wo     , Wo     , Ww     , Gs     , Gs     , Gs     , Gs     , Gs     , Gs     , Gs     , Gs     , Gs     , Gs     , Gs     , Gs     , Gs     , Gs     , Gs     , Gs     , Gs     , Gs     , Gs     , Gs     , Gs     , Gs     , Gs     , Gs     , Gs     , Gs     , Gs     , Gs     , Hh     , Hh     , Gs     , Gs     , Gs     , Gs     , Gs     , Gs     , Gs     , Gs     , Gs     , Gs     , Gs     , Gs     
Wo     , Wo     , Wo     , Wo     , Wo     , Wo     , Wo     , Wo     , Ds     , Ds     , Gs     , Gs     , Gs     , Gs     , Gs     , Gs     , Gs     , Gs     , Gs     , Gs     , Gs     , Gs     , Gs     , Gs     , Gs     , Gs     , Gs     , Gs     , Gs     , Gs     , Gs     , Gs     , Gs     , Gs     , Gs     , Gs     , Hh     , Hh     , Hh     , Gs     , Gs     , Gs     , Gs     , Gs     , Gs     , Gs     , Gs     , Gs     , Gs     , Gs     
Wo     , Wo     , Wo     , Wo     , Wo     , Wo     , Wo     , Wo     , Ww     , Ds     , Gs     , Gs     , Gs     , Gs     , Gs     , Gs^Vht    , Gs     , Gs     , Gs     , Gs     , Gs     , Gs     , Gs     , Gs     , Gs     , Gs     , Gs     , Gs     , Gs     , Hh     , Qxu    , Hh     , Gs     , Gs     , Gs     , Gs     , Gs     , Hh     , Hh     , Hh     , Gs     , Gs     , Gs     , Gs     , Gs     , Gs     , Gs     , Gs     , Gs     , Gs     
Wo     , Wo     , Wo     , Wo     , Wo     , Wo     , Wo     , Wo     , Ww     , Ww     , Ds     , Ds     , Gs     , Gs     , Gs     , Gs     , Gs     , Gs     , Gs     , Gs     , Gs     , Gs     , Gs     , Gs     , Gs     , Gs     , Gs     , Gs     , Hh     , Qxu    , Qxu    , Hh     , Hh     , Gs     , Gs     , Hh     , Hh     , Gs     , Hh     , Hh     , Gs     , Gs     , Gs     , Gs     , Gs^Vht    , Gs     , Gs     , Gs     , Gs     , Gs     
Wo     , Wo     , Wo     , Wo     , Wo     , Wo     , Wo     , Wo     , Wo     , Ww     , Ww     , Ds     , Gs     , Ds     , Gs     , Gs     , Gs     , Gs     , Gs     , Gs     , Gs     , Gs     , Gs     , Gs     , Gs     , Gs     , Gs     , Gs     , Gs     , Qxu    , Hh     , Hh     , Hh     , Gs     , Gs     , Hh     , Gs     , Gs     , Gs     , Gs     , Hh     , Hh     , Gs     , Gs     , Gs     , Gs     , Gs     , Gs     , Gs     , Gs     
Wo     , Wo     , Wo     , Wo     , Wo     , Wo     , Wo     , Wo     , Wo     , Wo     , Ww     , Ds     , Ds     , Ds     , Gs     , Gs     , Gs     , Gs     , Gs     , Gs     , Gs     , Gs     , Gs     , Gs     , Gs     , Gs     , Gs     , Gs     , Gs     , Qxu    , Hh     , Hh     , Gs     , Hh     , Hh     , Gs     , Gs     , Ch     , Ch     , Ch     , Hh     , Hh     , Gs     , Gs     , Gs     , Gs     , Gs     , Gs     , Gs     , Gs     
Wo     , Wo     , Wo     , Wo     , Wo     , Wo     , Wo     , Wo     , Wo     , Wo     , Wo     , Ww     , Ww     , Ds     , Gs     , Gs     , Gs     , Gs     , Gs     , Gs     , Gs     , Gs     , Gs^Vht    , Gs     , Gs     , Gs     , Gs     , Gs     , Hh     , Qxu    , Hh     , Hh     , Hh     , Hh     , Gs     , Gs     , Gs     , Ch     , 2 Kh   , Ch     , Gs     , Hh     , Gs     , Gs     , Gs     , Gs     , Gs     , Gs     , Gs     , Gs     
Wo     , Wo     , Wo     , Wo     , Wo     , Wo     , Wo     , Wo     , Wo     , Wo     , Wo     , Wo     , Ww     , Ww     , Ds     , Ds     , Gs     , Gs     , Gs     , Gs     , Gs     , Gs     , Gs     , Gs     , Gs     , Gs     , Gs     , Gs     , Qxu    , Hh     , Hh     , Hh     , Hh     , Hh     , Gs     , Gs     , Gs     , Gs     , Ch     , Gs     , Gs     , Hh     , Hh     , Hh     , Gs     , Gs     , Gs     , Gs     , Gs     , Gs     
Wo     , Wo     , Wo     , Wo     , Wo     , Wo     , Wo     , Wo     , Wo     , Wo     , Wo     , Wo     , Wo     , Ww     , Ds     , Ds     , Gs     , Gs     , Gs     , Gs     , Gs     , Gs     , Gs     , Gs     , Gs     , Gs     , Gs     , Gs     , Qxu    , Hh     , Hh     , Hh     , Hh     , Hh     , Gs     , Gs     , Gs     , Gs     , Gs     , Hh     , Hh     , Hh     , Hh     , Hh     , Gs     , Gs     , Gs     , Gs     , Gs     , Gs     
Wo     , Wo     , Wo     , Wo     , Wo     , Hh     , Wo     , Wo     , Wo     , Wo     , Wo     , Wo     , Wo     , Wo     , Ww     , Ww     , Ds     , Ds     , Gs     , Gs     , Gs     , Gs     , Gs     , Gs     , Gs     , Gs     , Gs     , Qxu    , Qxu    , Hh     , Hh     , Hh     , Hh     , Hh     , Gs     , Gs     , Gs     , Gs     , Gs     , Hh     , Hh     , Hh     , Hh     , Hh     , Hh     , Gs     , Gs     , Gs     , Gs     , Gs     
Wo     , Wo     , Wo     , Wo     , Wo     , Wo     , Wo     , Wo     , Wo     , Wo     , Wo     , Wo     , Wo     , Wo     , Wo     , Ds     , Ww     , Ds     , Gs     , Gs     , Gs     , Gs     , Gs     , Gs     , Gs     , Gs     , Gs^Vht    , Gs     , Qxu    , Hh     , Hh     , Hh     , Hh     , Hh     , Hh     , Gs     , Gs     , Gs     , Hh     , Hh     , Hh     , Hh     , Hh     , Hh     , Hh     , Gs     , Gs     , Gs     , Gs     , Gs     
Wo     , Wo     , Wo     , Wo     , Wo     , Wo     , Wo     , Wo     , Wo     , Wo     , Wo     , Wo     , Wo     , Wo     , Wo     , Wo     , Ds     , Ww     , Ds     , Ds     , Gs     , Gs     , Qxu    , Qxu    , Gs     , Qxu    , Qxu    , Qxu    , Qxu    , Gs     , Hh     , Hh     , Hh     , Hh     , Hh     , Hh     , Gs     , Gs     , Hh     , Hh     , Hh     , Hh     , Hh     , Hh     , Hh     , Gs     , Gs     , Gs     , Gs     , Gs     
Wo     , Wo     , Wo     , Wo     , Wo     , Wo     , Wo     , Wo     , Wo     , Wo     , Wo     , Wo     , Wo     , Wo     , Wo     , Wo     , Wo     , Ww     , Ww     , Ds     , Gs     , Gs     , Gs     , Gs     , Qxu    , Gs     , Gs     , Hh     , Hh     , Hh     , Hh     , Hh     , Hh     , Hh     , Hh     , Hh     , Hh     , Hh     , Hh     , Hh^Vhh    , Hh     , Hh     , Hh     , Hh     , Gs     , Gs     , Gs     , Gs     , Gs     , Gs     
Wo     , Wo     , Wo     , Wo     , Wo     , Wo     , Wo     , Wo     , Wo     , Wo     , Wo     , Wo     , Ww^Vm    , Wo     , Wo     , Wo     , Wo     , Wo     , Ww     , Ww     , Ds     , Ds     , Gs     , Gs     , Gs     , Gs     , Gs     , Gs     , Gs     , Hh     , Hh     , Hh     , Hh     , Hh     , Hh     , Hh     , Hh     , Hh     , Hh     , Hh     , Hh     , Hh     , Hh     , Hh     , Hh     , Gs     , Gs     , Gs     , Gs     , Gs     
Wo     , Wo     , Wo     , Wo     , Wo     , Wo     , Wo     , Wo     , Wo     , Wo     , Wo     , Wo     , Wo     , Wo     , Wo     , Wo     , Wo     , Wo     , Wo     , Ww     , Ww     , Ds     , Gs     , Gs     , Gs     , Gs     , Gs     , Gs     , Hh     , Hh     , Hh     , Hh     , Hh     , Hh     , Hh     , Hh     , Hh     , Hh     , Hh     , Hh     , Hh     , Hh     , Hh     , Hh     , Hh     , Hh     , Gs     , Gs     , Gs     , Gs     
Wo     , Wo     , Wo     , Wo     , Wo     , Wo     , Wo     , Wo     , Wo     , Wo     , Wo     , Wo     , Wo     , Wo     , Wo     , Wo     , Wo     , Wo     , Wo     , Ds     , Ds     , Ds     , Ds     , Gs     , Gs     , Gs     , Gs     , Gs     , Gs     , Hh     , Hh     , Hh     , Hh     , Hh     , Hh     , Hh     , Hh     , Hh     , Hh     , Hh     , Hh     , Hh     , Hh     , Hh     , Hh     , Gs     , Gs     , Gs     , Gs     , Gs     
Wo     , Wo     , Wo     , Wo     , Wo     , Wo     , Wo     , Wo     , Wo     , Wo     , Wo     , Ww     , Wo     , Ww     , Wo     , Wo     , Wo     , Wo     , Ww     , Ww     , Ds     , Ds     , Gs     , Gs     , Gs     , Hh     , Gs     , Hh     , Hh     , Hh     , Hh     , Hh     , Hh     , Hh^Vhh    , Hh     , Hh     , Hh     , Hh     , Hh     , Hh     , Hh     , Hh     , Hh     , Hh     , Hh     , Gs     , Gs     , Gs     , Gs     , Gs     
Wo     , Wo     , Wo     , Wo     , Wo     , Wo     , Wo     , Wo     , Wo     , Ww     , Ww     , Ds     , Ww     , Ds     , Ww     , Ww     , Wo     , Ww     , Wo     , Ww     , Ds     , Ds     , Gs     , Gs     , Gs     , Hh     , Hh     , Hh     , Hh     , Hh     , Hh     , Hh     , Hh     , Hh     , Hh     , Hh     , Hh     , Hh     , Hh     , Hh     , Hh     , Hh     , Hh     , Hh     , Hh     , Hh     , Gs     , Gs     , Gs     , Gs     
Wo     , Wo     , Wo     , Wo     , Wo     , Wo     , Wo     , Wo     , Wo     , Ww     , Ww     , Ds     , Ds     , Gs     , Ds     , Ds     , Ww     , Ds     , Ww     , Ds     , Ds     , Ds     , Gs     , Gs     , Gs     , Gs     , Hh     , Hh     , Hh     , Hh     , Hh     , Hh     , Hh     , Hh     , Hh     , Hh     , Hh     , Hh     , Hh     , Hh     , Hh     , Hh     , Hh     , Hh     , Hh     , Hh     , Gs     , Gs     , Gs     , Gs     
Wo     , Wo     , Wo     , Wo     , Wo     , Wo     , Wo     , Wo     , Ww     , Ww     , Ds     , Gs     , Gs     , Gs     , Gs     , Gs     , Ds     , Gs     , Ds     , Gs     , Gs^Vht    , Ds     , Gs     , Gs     , Gs     , Gs     , Hh     , Hh     , Hh     , Hh     , Hh     , Hh     , Hh     , Hh     , Hh     , Hh     , Hh     , Hh     , Hh     , Hh     , Hh     , Hh     , Hh     , Hh     , Hh     , Hh     , Hh     , Hh     , Gs     , Gs     
Wo     , Wo     , Wo     , Wo     , Wo     , Wo     , Wo     , Ww^Bw\   , Ww     , Ds     , Ds     , Gs     , Gs     , Gs     , Gs     , Gs     , Gs     , Gs     , Gs     , Gs     , Gs     , Gs     , Gs     , Gs     , Gs     , Gs     , Gs     , Hh     , Hh     , Hh     , Hh     , Hh     , Hh     , Hh     , Hh     , Hh     , Hh     , Hh     , Hh     , Hh     , Hh     , Hh     , Hh     , Hh     , Hh     , Hh     , Hh     , Hh     , Gs     , Gs     
Wo     , Wo     , Wo     , Wo     , Wo     , Wo     , Wo     , Ww     , Ds     , Ds     , Gs     , Gs     , Gs     , Gs     , Gs     , Gs     , Gs     , Gs     , Gs     , Gs     , Gs     , Gs     , Gs     , Gs     , Gs     , Gs     , Hh     , Hh     , Hh     , Hh     , Hh     , Hh     , Hh     , Hh     , Hh     , Hh     , Hh     , Hh     , Hh     , Hh     , Hh     , Ch     , Ch     , Ch     , Hh     , Hh     , Hh     , Hh     , Hh     , Gs     
Wo     , Wo     , Wo     , Wo     , Wo     , Ww     , Ww     , Ds     , Ww     , Ds     , Gs     , Gs     , Gs     , Ce     , Gs     , Gs     , Gs     , Gs     , Gs     , Gs     , Gs     , Gs     , Gs     , Gs     , Gs     , Gs     , Hh     , Hh     , Hh     , Hh     , Hh     , Hh     , Hh     , Hh     , Hh     , Hh     , Hh     , Hh     , Hh     , Hh     , Hh     , Ch     , 3 Kh   , Ch     , Hh     , Hh     , Hh     , Hh     , Gs     , Gs     
Wo     , Wo     , Wo     , Wo     , Wo     , Ww     , Ds     , Gs     , Ds     , Gs     , Gs     , Gs     , Ce     , 1 Ke   , Ce     , Gs     , Gs     , Gs     , Gs     , Gs     , Gs     , Gs     , Gs     , Gs     , Gs     , Hh     , Hh     , Hh     , Hh     , Hh     , Hh     , Mm^Vhh    , Mm     , Hh     , Hh     , Hh     , Hh     , Hh     , Hh     , Hh     , Hh     , Hh     , Ch     , Hh     , Hh     , Hh     , Hh     , Hh     , Gs     , Gs     
Wo     , Wo     , Wo     , Wo     , Wo     , Ww     , Ds     , Ds     , Gs     , Gs     , Gs     , Gs     , Ce     , Ce     , Ce     , Gs     , Gs     , Gs     , Gs     , Gs     , Gs     , Gs     , Gs     , Gs     , Gs     , Hh     , Hh     , Hh     , Hh     , Hh     , Mm     , Mm     , Mm     , Hh     , Hh     , Hh     , Hh     , Hh     , Hh     , Hh     , Hh     , Hh     , Hh     , Hh     , Hh     , Hh     , Hh     , Hh     , Gs     , Gs     
Wo     , Wo     , Wo     , Wo     , Wo     , Wo     , Ww     , Ds     , Gs     , Gs     , Gs     , Gs     , Gs     , Gs     , Gs     , Gs     , Gs     , Gs     , Gs     , Gs     , Gs     , Gs     , Gs     , Gs     , Gs     , Gs     , Hh     , Hh     , Hh^Vhh    , Hh     , Hh     , Hh     , Hh     , Hh     , Hh     , Hh     , Hh     , Hh     , Hh     , Hh     , Hh     , Hh     , Hh     , Hh     , Hh     , Hh     , Hh     , Hh     , Gs     , Gs     
Wo     , Wo     , Wo     , Wo     , Wo     , Wo     , Ww     , Ww     , Ds     , Ds     , Gs     , Gs     , Gs     , Gs     , Gs     , Gs^Vht    , Gs     , Gs     , Gs     , Gs     , Gs     , Gs     , Gs     , Gs     , Gs     , Gs     , Hh     , Hh     , Hh     , Hh     , Hh     , Hh     , Hh     , Hh     , Hh     , Hh     , Hh     , Hh     , Hh     , Hh     , Hh     , Hh     , Hh     , Hh     , Hh     , Hh     , Hh     , Hh     , Hh     , Gs     
Wo     , Wo     , Wo     , Wo     , Wo     , Wo     , Wo     , Wo     , Ww     , Ww     , Ds     , Gs     , Gs     , Gs     , Gs     , Gs     , Gs     , Gs     , Gs     , Gs     , Gs     , Gs     , Gs     , Gs     , Gs     , Gs     , Gs     , Gs     , Gs     , Hh     , Hh     , Hh     , Hh     , Hh     , Hh     , Hh     , Hh     , Hh     , Hh     , Hh     , Hh     , Hh     , Hh^Vhh    , Hh     , Hh     , Hh     , Hh     , Hh     , Hh     , Gs     
Wo     , Wo     , Wo     , Wo     , Wo     , Wo     , Wo     , Wo     , Wo     , Ww     , Ds     , Ds     , Gs     , Gs     , Gs     , Ds     , Gs     , Gs     , Gs     , Gs     , Gs     , Gs     , Gs     , Gs     , Gs     , Gs     , Gs     , Gs     , Gs     , Hh     , Hh     , Hh     , Hh     , Hh     , Hh     , Hh     , Hh     , Hh     , Hh     , Hh     , Hh     , Hh     , Hh     , Hh     , Hh     , Hh     , Hh     , Hh     , Hh     , Hh     
Wo     , Wo     , Wo     , Wo     , Wo     , Wo     , Wo     , Wo     , Wo     , Wo     , Ww     , Ww     , Ds     , Ds     , Gs     , Ds     , Ds     , Ds     , Gs     , Ds     , Ds     , Gs     , Gs     , Gs     , Gs     , Gs     , Gs     , Gs     , Gs     , Gs     , Gs     , Hh     , Hh     , Hh     , Hh     , Hh     , Hh     , Hh     , Hh     , Hh     , Hh     , Hh     , Hh     , Gs     , Gs     , Gs     , Gs     , Hh     , Gs     , Hh     
Wo     , Wo     , Wo     , Wo     , Wo     , Wo     , Wo     , Wo     , Wo     , Wo     , Wo     , Ww     , Ds     , Ww     , Ds     , Ww     , Ww     , Ww     , Ds     , Ww     , Ds     , Ds     , Gs     , Gs     , Gs     , Gs     , Gs^Vht    , Gs     , Gs     , Gs     , Hh     , Hh     , Hh     , Hh     , Hh     , Gs     , Hh     , Hh     , Hh^Vhh    , Hh     , Hh     , Hh     , Hh     , Hh     , Gs     , Gs     , Gs     , Gs     , Hh     , Gs     
Wo     , Wo     , Wo     , Wo     , Wo     , Wo     , Wo     , Wo     , Wo     , Wo     , Wo     , Wo     , Ww     , Wo     , Ww     , Wo     , Wo     , Wo     , Ww     , Ww     , Ww     , Ds     , Gs     , Gs     , Gs     , Gs     , Gs     , Gs     , Gs     , Gs     , Hh     , Hh     , Hh     , Hh     , Gs     , Gs     , Hh     , Hh     , Hh     , Hh     , Hh     , Hh     , Hh     , Hh     , Gs     , Gs     , Gs     , Gs     , Gs     , Gs     
Wo     , Wo     , Wo     , Wo     , Wo     , Wo     , Wo     , Wo     , Wo     , Wo     , Wo     , Wo     , Wo     , Wo     , Wo     , Wo     , Wo     , Wo     , Wo     , Ds     , Ww     , Ds     , Gs     , Gs     , Gs     , Gs     , Gs     , Gs     , Gs     , Gs     , Gs     , Hh     , Hh     , Gs     , Gs     , Gs     , Gs     , Gs     , Hh     , Hh     , Hh     , Hh     , Hh     , Hh     , Gs     , Gs     , Gs     , Gs     , Gs     , Gs     
Wo     , Wo     , Wo     , Wo     , Wo     , Wo     , Wo     , Wo     , Wo     , Wo     , Wo     , Wo     , Wo     , Wo     , Wo     , Wo     , Wo     , Wo     , Wo     , Ww     , Ds     , Ds     , Gs     , Gs     , Gs     , Gs     , Gs     , Gs     , Gs     , Gs     , Gs     , Gs     , Gs     , Gs     , Gs     , Gs     , Gs     , Gs     , Hh     , Hh     , Hh     , Hh     , Hh     , Hh     , Gs     , Gs     , Gs     , Gs     , Gs     , Gs     
Wo     , Wo     , Wo     , Wo     , Wo     , Wo     , Wo     , Wo     , Wo     , Wo     , Wo     , Wo     , Wo     , Wo     , Wo     , Wo     , Wo     , Wo     , Wo     , Ww     , Ww     , Ds     , Gs     , Gs     , Gs     , Gs     , Gs     , Gs     , Gs     , Gs     , Gs     , Gs     , Gs     , Gs     , Gs     , Gs     , Gs     , Gs     , Hh     , Hh     , Hh     , Hh     , Hh     , Hh     , Hh     , Gs     , Gs     , Gs     , Gs     , Gs     
Wo     , Wo     , Wo     , Wo     , Wo     , Wo     , Wo     , Wo     , Wo     , Wo     , Wo     , Wo     , Wo     , Wo     , Wo     , Wo     , Wo     , Wo     , Wo     , Ds     , Ww     , Ds     , Gs     , Gs     , Gs     , Gs     , Gs     , Gs     , Gs     , Gs     , Gs     , Gs     , Gs     , Gs     , Gs     , Gs     , Gs     , Hh     , Hh     , Hh     , Hh     , Hh     , Hh     , Hh     , Hh     , Gs     , Gs     , Gs     , Gs     , Gs     
Wo     , Wo     , Wo     , Wo     , Wo     , Wo     , Wo     , Wo     , Wo     , Wo     , Wo     , Wo     , Wo     , Wo     , Wo     , Wo     , Wo     , Wo     , Ww     , Ww     , Ds     , Gs     , Gs     , Gs     , Gs     , Gs     , Gs     , Gs     , Gs     , Gs     , Gs     , Ch     , Gs     , Gs     , Gs     , Gs     , Gs     , Hh     , Hh     , Hh     , Hh     , Hh     , Hh     , Hh     , Gs     , Gs     , Gs     , Gs     , Gs     , Gs     
Wo     , Wo     , Wo     , Wo     , Wo     , Wo     , Wo     , Wo     , Wo     , Wo     , Ww^Vm    , Wo     , Wo     , Wo     , Wo     , Wo     , Wo     , Wo     , Ww     , Ww     , Ds     , Gs     , Gs     , Gs     , Gs     , Gs     , Gs     , Gs     , Gs     , Gs     , Ch     , 4 Kh   , Ch     , Gs     , Gs     , Gs     , Gs     , Gs     , Hh     , Hh     , Hh     , Hh     , Hh     , Gs     , Gs     , Gs     , Gs     , Gs     , Gs     , Gs     
Wo     , Wo     , Wo     , Wo     , Wo     , Wo     , Wo     , Wo     , Wo     , Wo     , Wo     , Wo     , Wo     , Wo     , Wo     , Wo     , Wo     , Wo     , Wo     , Ww     , Ds     , Ds     , Gs     , Gs     , Gs     , Gs     , Gs     , Gs     , Gs     , Gs     , Ch     , Ch     , Ch     , Gs     , Gs     , Gs     , Gs     , Gs     , Hh     , Hh     , Hh     , Hh     , Hh     , Gs     , Gs     , Gs     , Gs     , Gs     , Gs     , Gs     
Wo     , Wo     , Wo     , Wo     , Wo     , Wo     , Wo     , Wo     , Wo     , Wo     , Wo     , Wo     , Wo     , Wo     , Wo     , Wo     , Wo     , Wo     , Wo     , Ww     , Ds     , Ds     , Gs     , Gs     , Gs     , Gs     , Gs     , Gs     , Gs     , Gs     , Gs     , Gs     , Gs     , Gs     , Gs     , Gs     , Gs     , Gs     , Gs     , Hh     , Hh     , Hh     , Hh     , Hh     , Gs     , Hh     , Gs     , Gs     , Gs     , Gs     
Wo     , Wo     , Wo     , Wo     , Wo     , Wo     , Wo     , Wo     , Wo     , Wo     , Wo     , Wo     , Wo     , Wo     , Wo     , Wo     , Wo     , Wo     , Wo     , Ww     , Ww     , Ds     , Ds     , Gs     , Gs     , Gs     , Gs     , Gs     , Gs     , Gs     , Gs     , Gs     , Gs     , Gs     , Gs     , Gs     , Gs     , Gs     , Gs     , Hh     , Hh     , Hh     , Hh     , Hh     , Hh     , Hh     , Gs     , Gs     , Gs     , Gs     
Wo     , Wo     , Wo     , Wo     , Wo     , Wo     , Wo     , Wo     , Wo     , Wo     , Wo     , Wo     , Wo     , Wo     , Wo     , Wo     , Wo     , Wo     , Ww     , Ww     , Ds     , Ds     , Gs     , Gs     , Gs     , Gs     , Gs     , Gs     , Gs     , Gs     , Gs     , Gs     , Gs     , Gs     , Gs     , Gs     , Gs     , Gs     , Hh     , Hh     , Hh     , Hh     , Hh     , Hh     , Hh     , Gs     , Gs     , Gs     , Gs     , Gs     
Wo     , Wo     , Wo     , Wo     , Wo     , Wo     , Wo     , Wo     , Wo     , Wo     , Wo     , Wo     , Wo     , Wo     , Wo     , Wo     , Wo     , Wo     , Ww     , Ww     , Ds     , Ds     , Gs     , Gs     , Gs     , Gs     , Gs     , Gs     , Gs     , Gs     , Gs     , Gs^Vht    , Gs     , Gs     , Gs     , Gs     , Gs     , Gs     , Hh     , Gs     , Hh     , Hh     , Hh     , Hh     , Hh     , Gs     , Gs     , Gs     , Gs     , Gs     
Wo     , Wo     , Wo     , Wo     , Wo     , Wo     , Wo     , Wo     , Wo     , Wo     , Wo     , Wo     , Wo     , Wo     , Wo     , Wo     , Wo     , Wo     , Wo     , Ww     , Ww     , Ds     , Gs     , Gs     , Gs     , Gs     , Gs     , Gs     , Gs     , Gs     , Gs     , Gs     , Gs     , Gs     , Gs     , Gs     , Gs     , Gs     , Hh     , Hh     , Hh     , Hh     , Hh     , Hh     , Gs     , Gs     , Gs     , Gs     , Gs     , Gs     
Wo     , Wo     , Wo     , Wo     , Wo     , Wo     , Wo     , Wo     , Wo     , Wo     , Wo     , Wo     , Wo     , Wo     , Wo     , Wo     , Wo     , Wo     , Wo     , Ww     , Ww     , Ds     , Gs     , Gs     , Gs     , Gs     , Gs     , Gs     , Gs     , Gs     , Gs     , Gs     , Gs     , Gs     , Gs     , Gs     , Gs     , Gs     , Hh     , Hh     , Hh     , Hh     , Hh     , Hh     , Gs     , Gs     , Gs     , Gs     , Gs     , Gs     
Wo     , Wo     , Wo     , Wo     , Wo     , Wo     , Wo     , Wo     , Wo     , Wo     , Wo     , Wo     , Wo     , Wo     , Wo     , Wo     , Wo     , Wo     , Wo     , Ww     , Gs     , Ds     , Gs     , Gs     , Gs     , Gs     , Gs     , Gs     , Gs     , Gs     , Gs     , Gs     , Gs     , Gs     , Gs     , Gs     , Gs     , Gs     , Gs     , Hh     , Hh     , Hh     , Hh     , Hh     , Hh     , Gs     , Gs     , Gs     , Gs     , Gs     
Wo     , Wo     , Wo     , Wo     , Ww^Vm    , Wo     , Wo     , Wo     , Wo     , Wo     , Wo     , Wo     , Wo     , Wo     , Wo     , Wo     , Wo     , Wo     , Ww     , Ds     , Ds     , Gs     , Gs     , Gs     , Gs     , Gs     , Gs     , Gs     , Gs     , Gs     , Gs     , Gs     , Gs     , Gs     , Gs     , Gs     , Gs     , Gs     , Gs     , Gs     , Hh     , Hh^Vhh    , Hh     , Hh     , Hh     , Gs     , Gs     , Gs     , Gs     , Gs     
Wo     , Wo     , Wo     , Wo     , Wo     , Wo     , Wo     , Wo     , Wo     , Wo     , Wo     , Wo     , Wo     , Wo     , Wo     , Wo     , Wo     , Wo     , Ww     , Ds     , Ds     , Gs     , Gs     , Gs     , Gs     , Gs     , Gs     , Gs     , Gs     , Gs     , Gs     , Gs     , Gs     , Gs     , Gs     , Gs     , Gs     , Gs     , Gs     , Hh     , Hh     , Hh     , Hh     , Hh     , Gs     , Hh     , Gs     , Gs     , Gs     , Gs     
Wo     , Wo     , Wo     , Wo     , Wo     , Wo     , Wo     , Wo     , Wo     , Wo     , Wo     , Wo     , Wo     , Wo     , Wo     , Wo     , Wo     , Wo     , Ww     , Ww     , Ds     , Ds     , Gs     , Gs     , Gs     , Gs     , Gs     , Gs     , Gs     , Gs     , Gs     , Gs     , Gs     , Gs     , Gs     , Gs     , Gs     , Gs     , Gs     , Hh     , Hh     , Hh     , Hh     , Hh     , Hh     , Gs     , Gs     , Gs     , Gs     , Gs     
Wo     , Wo     , Wo     , Wo     , Wo     , Wo     , Wo     , Wo     , Wo     , Wo     , Wo     , Wo     , Wo     , Wo     , Wo     , Wo     , Wo     , Wo     , Wo     , Wo     , Ww     , Ds     , Gs     , Gs     , Gs     , Gs     , Gs     , Gs     , Gs     , Gs     , Gs     , Gs     , Gs     , Gs     , Gs     , Gs     , Gs     , Gs     , Gs     , Gs     , Gs     , Hh     , Hh     , Hh     , Gs     , Gs     , Gs     , Gs     , Gs     , Gs     
