Wo     , Wo     , Wo     , Wo     , Wo     , Wo     , Wo     , Wo     , Wo     , Wo     , Wo     , Wo     , Wo     , Wo     , Wo     , Wo     , Wo     , Wo     , Wo     , Wo     , Wo     , Wo     , Wo     , Wo     , Wo     , Wo     , Wo     , Wo     , Wo     , Wo     
Wo     , Wo     , Wo     , Wo     , Wo     , Wo     , Wo     , Wo     , Wo     , Wo     , Wo     , Wo     , Wo     , Wo     , Wo     , Wo     , Wo     , Ww^Vm    , Wo     , Wo     , Wo     , Wo     , Wo     , Wo     , Wo     , Wo     , Wo     , Wo     , Wo     , Wo     
Wo     , Wo     , Wo     , Wo     , Wo     , Wo     , Wo     , Wo     , Wo     , Wo     , Wo     , Wo     , Wo     , Wo     , Wo     , Wo     , Wo     , Wo     , Wo     , Wo     , Wo     , Wo     , Wo     , Wo     , Wo     , Wo     , Wo     , Wo     , Wo     , Wo     
Wo     , Wo     , Wo     , Wo     , Wo     , Wo     , Ww^Vm    , Wo     , Wo     , Wo     , Wo     , Wo     , Wo     , Wo     , Wo     , Wo     , Wo     , Wo     , Wo     , Wo     , Wo     , Wo     , Wo     , Wo     , Wo     , Wo     , Wo     , Wo     , Wo     , Wo     
Wo     , Wo     , Wo     , Wo     , Wo     , Wo     , Wo     , Wo     , Wo     , Wo     , Wo     , Wo     , Wo     , Wo     , Wo     , Wo     , Wo     , Wo     , Wo     , Wo     , Wo     , Wo     , Wo     , Wo     , Wo     , Wo     , Wo     , Wo     , Wo     , Wo     
Wo     , Wo     , Wo     , Wo     , Wo     , Wo     , Wo     , Wo     , Wo     , Wo     , Wo     , Wo     , Wo     , Wo     , Wo     , Wo     , Wo     , Wo     , Wo     , Wo     , Wo     , Ww     , Wo     , Wo     , Wo     , Wo     , Wo     , Wo     , Wo     , Wo     
Wo     , Wo     , Wo     , Wo     , Wo     , Wo     , Wo     , Wo     , Wo     , Wo     , Wo     , Wo     , Wo     , Wo     , Wo     , Wo     , Wo     , Wo     , Wo     , Wo     , Wo     , Wo     , Ww     , Wo     , Wo     , Wo     , Wo     , Wo     , Wo     , Wo     
Ww     , Ww     , Wo     , Ww     , Ww     , Ww     , Ww     , Ww     , Ww     , Wo     , Ww     , Ww     , Ww     , Ww     , Ww     , Ww     , Wo     , Ww     , Ww     , Ww     , Ww     , Ww     , Ww     , Ww     , Ww     , Wo     , Ww     , Ww     , Ww     , Ww     
Ww     , Ww     , Ww     , Ww     , Ww     , Ww^Bw\   , Ww     , Ww     , Wo     , Ww     , Ww     , Ww^Bw\   , Ww     , Gs     , Ww     , Ww     , Ww     , Ww     , Ww     , Ww     , Ww     , Ww     , Ww     , Ww^Bw\   , Ww     , Ww     , Ww     , Ww     , Ww     , Ww     
Ds     , Ds     , Ww     , Ww     , Ds     , Ce     , Ce     , Ce     , Ds     , Ds     , Ds     , Ce     , Ce     , Ce     , Ds     , Ds     , Ds     , Ds     , Ds     , Ww     , Ds     , Ds     , Ds     , Ce     , Ce     , Ce     , Ww     , Ww     , Ds     , Ds     
Gs     , Gs     , Ds     , Ds     , Ds     , Ce     , 1 Ke   , Ce     , Gs     , Gs     , Gs     , Ce     , 2 Ke   , Ce     , Gs     , Gs     , Gs     , Gs     , Ds     , Ds     , Gs     , Ds     , Gs     , Ce     , 3 Ke   , Ce     , Ww     , Ds     , Ds     , Gs     
Gs     , Gs     , Gs     , Gs     , Ds     , Gs     , Ce     , Gs     , Gs     , Gs     , Gs     , Gs^Vht    , Ce     , Gs     , Gs     , Gs     , Gs     , Gs     , Gs     , Gs     , Ds     , Gs     , Gs     , Gs     , Ce     , Gs     , Ds     , Gs     , Gs     , Gs     
Gs     , Gs     , Gs     , Gs     , Gs     , Gs^Vht    , Gs     , Gs     , Gs     , Gs     , Gs     , Gs     , Gs     , Gs     , Gs     , Gs     , Gs     , Gs     , Gs     , Gs     , Gs     , Gs     , Gs     , Gs     , Gs     , Gs     , Gs     , Gs^Vht    , Gs     , Gs     
Gs     , Gs     , Gs     , Gs     , Gs     , Gs     , Gs     , Gs     , Gs     , Gs     , Gs     , Hh     , Gs     , Hh     , Gs     , Gs     , Gs     , Gs     , Hh     , Gs     , Gs     , Gs     , Gs     , Gs     , Gs     , Gs     , Gs     , Gs     , Gs     , Gs     
Gs     , Gs     , Gs     , Gs     , Gs     , Gs     , Gs     , Gs     , Gs     , Gs     , Hh     , Hh     , Hh     , Hh     , Hh     , Hh     , Hh     , Hh     , Gs     , Hh     , Hh     , Hh     , Gs     , Hh     , Gs     , Gs     , Gs     , Gs     , Gs     , Gs     
Gs     , Gs     , Gs     , Gs     , Gs     , Gs     , Gs     , Gs     , Gs     , Gs     , Hh     , Hh     , Hh     , Hh     , Hh     , Hh     , Hh     , Hh     , Hh     , Hh     , Hh     , Hh     , Hh     , Hh     , Hh     , Hh     , Gs     , Gs     , Gs     , Gs     
Ww     , Ww     , Gs     , Hh     , Gs     , Hh     , Gs     , Gs     , Gs     , Hh     , Hh     , Hh     , Hh     , Hh     , Hh     , Hh     , Hh     , Hh     , Hh     , Hh     , Hh     , Hh     , Hh     , Hh     , Hh     , Hh     , Hh     , Gs     , Gs     , Gs     
Hh     , Hh     , Ww     , Ww     , Hh     , Hh     , Hh     , Hh     , Hh     , Hh     , Hh     , Hh     , Hh     , Hh     , Hh     , Hh     , Hh     , Hh     , Hh     , Hh     , Hh     , Hh     , Hh     , Hh     , Hh     , Hh     , Hh     , Hh     , Hh     , Gs     
Gs     , Hh     , Hh     , Hh     , Ww     , Ww     , Hh     , Hh     , Hh     , Hh     , Hh     , Hh     , Hh     , Hh     , Hh     , Hh     , Hh     , Hh     , Hh     , Hh     , Hh     , Hh     , Hh     , Hh     , Hh     , Hh     , Hh     , Gs     , Gs     , Gs     
Hh     , Gs     , Gs     , Gs     , Hh     , Ww     , Hh     , Hh     , Hh     , Hh     , Hh     , Hh     , Hh     , Hh     , Hh     , Hh     , Hh     , Hh     , Hh     , Hh     , Hh     , Hh     , Hh     , Hh     , Hh     , Hh     , Hh     , Gs     , Gs     , Gs     
Gs     , Gs     , Gs     , Gs^Vht    , Gs     , Ww     , Hh     , Hh     , Hh     , Hh     , Hh     , Hh     , Hh     , Hh     , Hh     , Hh     , Hh     , Hh     , Hh     , Hh     , Hh     , Hh     , Hh     , Hh     , Hh     , Hh     , Hh     , Gs     , Gs     , Gs     
Gs     , Gs     , Gs     , Gs     , Gs     , Hh     , Ww     , Ww     , Hh     , Hh     , Hh     , Hh     , Hh     , Hh     , Hh     , Gs     , Hh     , Hh     , Hh     , Hh     , Hh     , Hh     , Hh     , Gs     , Gs     , Gs     , Hh     , Hh     , Gs     , Hh     
Gs     , Gs     , Gs     , Gs     , Hh     , Hh     , Hh     , Hh     , Ww     , Hh     , Hh     , Gs     , Hh     , Gs     , Gs     , Gs     , Gs     , Gs     , Hh     , Hh     , Hh     , Hh     , Hh     , Hh     , Gs     , Gs     , Hh     , Hh     , Hh     , Gs     
Gs     , Gs     , Gs     , Hh     , Hh     , Ce     , Hh     , Ww     , Ww     , Hh     , Hh     , Gs     , Gs     , Gs     , Gs     , Ch     , Ch     , Ch     , Gs     , Hh     , Gs     , Hh     , Hh     , Gs     , Gs^Vht    , Gs     , Gs     , Gs     , Hh     , Gs     
Gs     , Gs     , Gs     , Gs     , Ce     , 5 Ke   , Ce     , Ww     , Hh     , Hh     , Hh     , Hh     , Gs     , Gs     , Gs     , Ch     , 4 Kh   , Ch     , Gs     , Gs     , Hh     , Hh     , Gs     , Hh     , Gs     , Gs     , Gs     , Gs     , Gs     , Gs     
Gs     , Gs     , Gs     , Hh     , Ce     , Ce     , Ce     , Hh     , Ww     , Ww     , Hh     , Hh     , Gs     , Gs     , Gs     , Gs     , Ch     , Gs     , Hh     , Hh     , Hh     , Hh     , Hh     , Hh     , Gs     , Hh     , Gs     , Hh     , Gs     , Gs     
Gs     , Gs     , Gs     , Hh     , Hh     , Hh     , Hh     , Hh     , Hh     , Ww     , Hh     , Hh     , Gs     , Hh     , Gs     , Gs     , Gs     , Hh     , Hh     , Gs     , Hh     , Hh     , Hh     , Hh     , Hh     , Hh     , Hh     , Hh     , Hh     , Hh     
Gs     , Gs     , Gs     , Hh     , Hh     , Hh     , Hh     , Hh     , Hh     , Ww     , Hh     , Hh     , Hh     , Hh     , Hh     , Hh     , Hh     , Hh     , Hh     , Hh     , Hh     , Hh^Vhh    , Hh     , Hh     , Hh     , Hh     , Hh     , Hh     , Hh     , Hh     
Gs     , Gs     , Hh     , Hh     , Hh     , Hh     , Hh     , Hh     , Hh     , Hh     , Ww     , Ww     , Hh     , Hh     , Hh     , Hh     , Hh     , Hh     , Hh     , Hh     , Hh     , Hh     , Hh     , Hh     , Hh     , Hh     , Hh     , Hh     , Hh     , Hh     
Gs     , Gs     , Hh     , Hh     , Hh     , Hh     , Hh^Vhh    , Hh     , Hh     , Hh     , Hh     , Ww     , Hh     , Hh     , Hh     , Hh     , Hh     , Hh     , Hh     , Hh     , Hh     , Hh     , Hh     , Hh     , Hh     , Hh     , Hh     , Hh     , Hh     , Hh     
