Gg     , Gg     , Gg     , Gg     , Gs^Fp     , Gs^Fp     , Gs^Fp     , Gs^Fp     , Gs^Fp     , Gs^Fp     , Gs^Fp     , Gs^Fp     , Gs^Fp     , Gs^Fp     , Gs^Fp     , Gs^Fp     , Gs^Fp     , Gs^Fp     , Gs^Fp     , Gs^Fp     , Gs^Fp     , Gs^Fp     , Gs^Fp     , Gs^Fp     , Gs^Fp     , Gs^Fp     , Gs^Fp     , Gs^Fp     , Gs^Fp     , Gs^Fp     , Gs^Fp     , Gs^Fp     , Gs^Fp     , Gs^Fp     , Gs^Fp     , Gs^Fp     , Gs^Fp     , Gs^Fp     , Gs^Fp     , Gs^Fp     , Gg     , Gg     , Gg     , Gg     , Gg     , Gg     , Gg     , Gg     , Gg     , Gg     
Gg     , Gg     , Gg     , Gg     , Gg     , Gs^Fp     , Gs^Fp     , Gs^Fp     , Gs^Fp     , Gs^Fp     , Gs^Fp     , Gs^Fp     , Gs^Fp     , Gs^Fp     , Gs^Fp     , Gs^Fp     , Gs^Fp     , Gs^Fp     , Gs^Fp     , Gs^Fp     , Gs^Fp     , Gs^Fp     , Gs^Fp     , Cv     , Gs^Fp     , Gs^Fp     , Gs^Fp     , Gs^Fp     , Gs^Fp     , Gs^Fp     , Gs^Fp     , Gs^Fp     , Gs^Fp     , Gs^Fp     , Gs^Fp     , Gs^Fp     , Gs^Fp     , Gs^Fp     , Gs^Fp     , Gg     , Gg     , Gg     , Gg     , Gg     , Gg     , Gg     , Gg     , Gg     , Gg     , Gg     
Gg     , Gg     , Gg     , Gg     , Gg     , Gg     , Gs^Fp     , Gs^Fp     , Gs^Fp     , Gs^Fp     , Gs^Fp     , Gs^Fp     , Gs^Fp     , Gs^Fp     , Gs^Fp     , Gs^Fp     , Gs^Fp     , Gs^Fp     , Gs^Fp     , Gs^Fp     , Gs^Fp     , Gs^Fp     , Cv     , 2 Kv   , Cv     , Gs^Fp     , Gs^Fp     , Gs^Fp     , Gs^Fp     , Gs^Fp     , Gs^Fp     , Gs^Fp     , Gs^Fp     , Gs^Fp     , Gs^Fp     , Gs^Fp     , Gs^Fp     , Gs^Fp     , Gs^Fp     , Gs^Fp     , Gg     , Gg     , Gg     , Gg     , Gg     , Gg     , Gg     , Gg     , Gg     , Gg     
Gg     , Gg     , Gg     , Gg     , Gg     , Gg     , Gs^Fp     , Gs^Fp     , Gs^Fp     , Gs^Fp     , Gs^Fp     , Gs^Fp     , Gs^Fp     , Gs^Fp     , Gs^Fp     , Gs^Fp     , Gs^Fp     , Gs^Fp     , Gs^Fp     , Gs^Fp     , Gs^Fp     , Gs^Fp     , Cv     , Cv     , Cv     , Gs^Fp     , Gs^Fp     , Gs^Fp     , Gs^Fp     , Gs^Fp     , Gs^Fp     , Gs^Fp     , Gs^Fp     , Gs^Fp     , Gs^Fp     , Gs^Fp     , Gs^Fp     , Gs^Fp     , Gs^Fp     , Gs^Fp     , Gg     , Gg     , Gg     , Gg     , Gg     , Gg^Vh    , Gg     , Gg     , Gg     , Gg     
Gg     , Gg^Vh    , Gg     , Gg     , Gg     , Gg     , Gs^Fp     , Gs^Fp     , Gs^Fp     , Gs^Fp     , Gs^Fp     , Gs^Fp     , Gs^Fp     , Gs^Fp     , Gs^Fp     , Gs^Fp     , Gg^Ve    , Gs^Fp     , Gs^Fp     , Gs^Fp     , Gs^Fp     , Gs^Fp     , Gs^Fp     , Gs^Fp     , Gs^Fp     , Gs^Fp     , Gs^Fp     , Gs^Fp     , Gs^Fp     , Gs^Fp     , Gs^Fp     , Gg^Ve    , Gs^Fp     , Gs^Fp     , Gs^Fp     , Gs^Fp     , Gs^Fp     , Gs^Fp     , Gs^Fp     , Gg     , Gg     , Gg     , Gg     , Gg     , Gg     , Re     , Gg     , Gg     , Gg     , Gg     
Gg     , Gg     , Re     , Re     , Gg     , Gg     , Gg     , Gg     , Gs^Fp     , Gg     , Gs^Fp     , Gs^Fp     , Gs^Fp     , Gs^Fp     , Gs^Fp     , Gs^Fp     , Gs^Fp     , Gs^Fp     , Gs^Fp     , Gs^Fp     , Gs^Fp     , Gs^Fp     , Gs^Fp     , Gs^Fp     , Gs^Fp     , Gs^Fp     , Gs^Fp     , Gs^Fp     , Gs^Fp     , Gs^Fp     , Gs^Fp     , Gs^Fp     , Gs^Fp     , Gs^Fp     , Gs^Fp     , Gs^Fp     , Gs^Fp     , Gs^Fp     , Gg     , Gg     , Gg     , Gg     , Gg     , Re     , Re     , Gg     , Gg     , Gg     , Gg     , Gg     
Gg     , Gg     , Gg     , Re     , Gg     , Gg     , Gg     , Gg     , Gg     , Gg     , Gg     , Gg     , Gg     , Gg     , Gs^Fp     , Gs^Fp     , Gs^Fp     , Gs^Fp     , Gs^Fp     , Gg     , Gs^Fp     , Gs^Fp     , Gs^Fp     , Gs^Fp     , Gs^Fp     , Gs^Fp     , Gs^Fp     , Gs^Fp     , Gs^Fp     , Gs^Fp     , Gs^Fp     , Gs^Fp     , Gs^Fp     , Gs^Fp     , Gs^Fp     , Gg     , Gg     , Gg     , Re     , Re     , Gg     , Re     , Gg     , Re     , Gg     , Gg     , Gg     , Gg     , Gg     , Gg     
Gg     , Gg     , Gg     , Re     , Gg     , Gg     , Gg     , Gg     , Gg^Vh    , Gg     , Gg     , Gg     , Gg     , Gg     , Gg     , Gs^Fp     , Gs^Fp     , Gg     , Gg     , Gg     , Gg     , Gs^Fp     , Gs^Fp     , Gs^Fp     , Gg^Ve    , Gs^Fp     , Gs^Fp     , Gs^Fp     , Gs^Fp     , Gs^Fp     , Gs^Fp     , Gs^Fp     , Gs^Fp     , Gs^Fp     , Gg     , Gg     , Gg     , Gg     , Gg     , Gg     , Re     , Gg     , Re     , Gg     , Gg     , Gg     , Gg     , Gg     , Gg     , Gg     
Gg     , Gg     , Gg     , Gg     , Gg     , Gg     , Gg     , Gg     , Gg     , Gg     , Gg     , Gg     , Gg     , Gg     , Gg     , Gg     , Gg     , Gg     , Gg     , Gg     , Gg     , Gs^Fp     , Gs^Fp     , Gs^Fp     , Gs^Fp     , Gs^Fp     , Gs^Fp     , Gs^Fp     , Gs^Fp     , Gs^Fp     , Gs^Fp     , Gs^Fp     , Gs^Fp     , Gg     , Gg     , Gg     , Gg     , Gg     , Gg     , Gg     , Gg     , Gg     , Re     , Gg     , Gg     , Gg     , Gg     , Gg     , Gg     , Gg     
Gg     , Hh     , Gg     , Gg     , Re     , Gg     , Gg     , Gg     , Gg     , Gg     , Gg     , Gg     , Gg     , Gg     , Gg     , Gg     , Gg     , Gg     , Gg     , Gg     , Gg     , Gg     , Gs^Fp     , Re     , Gs^Fp     , Gg     , Gs^Fp     , Gs^Fp     , Gs^Fp     , Gg     , Gs^Fp     , Gs^Fp     , Gg     , Gg     , Gg     , Gg     , Gg     , Gg     , Gg     , Gg     , Gg     , Re     , Re     , Gg     , Gg     , Gg     , Gg     , Gg     , Gg     , Gg     
Hh     , Hh     , Hh     , Hh     , Hh     , Hh     , Gg     , Gg     , Gg     , Gg     , Gg     , Gg     , Gg     , Gg     , Gg     , Gg     , Gg     , Gg     , Gg     , Gg     , Gg     , Gg     , Re     , Gg     , Gg     , Gg     , Gg     , Gg     , Gs^Fp     , Gg     , Gg     , Gg     , Gg     , Gg^Vh    , Gg     , Gg     , Gg     , Gg     , Gg     , Gg     , Re     , Gg     , Gg     , Gg     , Gg     , Gg     , Gg     , Gg     , Gg     , Gg     
Hh     , Mm     , Hh     , Hh     , Hh     , Hh     , Rr     , Rr     , Rr     , Rr     , Rr     , Rr     , Rr     , Rr     , Rr     , Rr     , Rr     , Rr     , Rr     , Rr     , Rr     , Rr     , Rr     , Rr     , Rr     , Rr     , Rr     , Rr     , Rr     , Rr     , Rr     , Rr     , Rr     , Rr     , Rr     , Rr     , Rr     , Rr     , Rr     , Rr     , Rr     , Rr     , Rr     , Rr     , Rr     , Rr     , Rr     , Rr     , Rr     , Rr     
Mm     , Mm     , Hh     , Hh     , Hh     , Hh     , Hh     , Gg     , Gg     , Gg     , Gg     , Gg     , Gg     , Gg     , Gg     , Gg     , Gg     , Gg     , Gg     , Gg     , Gg     , Gg     , Gg     , Gs^Fp     , Gg     , Gg     , Gg     , Gg     , Gg     , Gg     , Gg     , Gg     , Gg     , Gg     , Gg     , Gg     , Gg     , Gg     , Gg     , Gg     , Gg     , Gg     , Gg     , Gg     , Gg     , Gg     , Gg     , Gg     , Gg     , Gg     
Mm     , Mm     , Mm     , Hh     , Hh     , Hh     , Hh     , Hh     , Gg     , Gg     , Gg     , Gg     , Gg     , Gg     , Gg     , Gg     , Gg     , Gg     , Gg     , Gs^Fp     , Gs^Fp     , Gs^Fp     , Gs^Fp     , Gs^Fp     , Gg     , Gg     , Gg     , Gg     , Gg     , Gg     , Gg     , Gg     , Gg     , Gg     , Gg     , Gg     , Gg     , Gg     , Gg     , Gg     , Gg     , Gg     , Gg     , Gg     , Gg     , Gg     , Gg^Vh    , Gg     , Gg     , Gg     
Mm     , Hh     , Hh     , Hh     , Hh     , Hh     , Hh     , Hh     , Gg     , Gg     , Gg     , Gg     , Gg     , Gg     , Gg     , Gg     , Gg     , Gg     , Gs^Fp     , Gs^Fp     , Gs^Fp     , Gs^Fp     , Gs^Fp     , Gs^Fp     , Gs^Fp     , Gs^Fp     , Gg     , Gg     , Gg     , Gg     , Gg     , Gg     , Gg     , Gg     , Gg     , Gg     , Gg     , Gg     , Gg     , Gg     , Gg     , Gg     , Gg     , Gg     , Gg     , Gg     , Gg     , Gg     , Gg     , Gg     
Hh     , Hh     , Hh     , Gg     , Hh     , Gg     , Hh     , Gg     , Hh     , Gg     , Gg     , Gg     , Gg     , Gg     , Gg     , Gg     , Gg     , Gg     , Gs^Fp     , Gs^Fp     , Gs^Fp     , Gg^Ve    , Gs^Fp     , Gs^Fp     , Gs^Fp     , Gs^Fp     , Gg     , Gg     , Gg     , Gg     , Gg     , Gg     , Gg     , Gg     , Gg     , Gg     , Gg     , Gg     , Gg     , Gg     , Gg     , Gg     , Gg     , Gg     , Gg     , Gg     , Gg     , Gg     , Gg     , Gg     
Hh     , Gg     , Gg     , Gg     , Gg     , Gg     , Gg     , Gg     , Gg     , Gg^Vh    , Gg     , Gg     , Gg     , Gg     , Gg     , Gg     , Gg     , Gg     , Gg     , Gs^Fp     , Gs^Fp     , Gs^Fp     , Gs^Fp     , Gs^Fp     , Gs^Fp     , Gg     , Gg     , Gg     , Gg     , Gg     , Gg     , Gg     , Gg     , Gg     , Gg     , Gg     , Gg     , Gg     , Gg     , Gg     , Gg     , Gg     , Gg     , Gg     , Gg     , Gg     , Gg     , Gg     , Gg     , Gg     
Gg     , Gg     , Gg     , Gg     , Gg     , Ch     , Gg     , Gg     , Gg     , Gg     , Gg     , Gg     , Gg     , Gg     , Gg     , Gg     , Gg     , Gg     , Gs^Fp     , Gs^Fp     , Gs^Fp     , Gs^Fp     , Gs^Fp     , Gs^Fp     , Gs^Fp     , Gs^Fp     , Gg     , Gg     , Gg     , Gg     , Gg     , Gg     , Gg     , Gg     , Gg     , Gg     , Gg     , Gg     , Gg     , Gg     , Gg     , Re^Gvs   , Re^Gvs   , Re^Gvs   , Gg     , Gg     , Gg     , Gg     , Gg     , Gg     
Gg     , Gg     , Gg     , Gg     , Ch     , 1 Kh   , Ch     , Gg     , Gg     , Gg     , Gg     , Gg     , Gg     , Gg     , Gg     , Gg     , Gg     , Gg     , Gs^Fp     , Gs^Fp     , Gs^Fp     , Gs^Fp     , Gs^Fp     , Gs^Fp     , Gs^Fp     , Gs^Fp     , Gs^Fp     , Gs^Fp     , Gg     , Gg     , Gg     , Gg     , Gg     , Gg     , Gg     , Gg     , Gg     , Gg     , Gg^Vh    , Re^Gvs   , Re^Gvs   , Re^Gvs   , Re^Gvs   , Re^Gvs   , Re^Gvs   , Gg     , Gg     , Gg     , Gg     , Gg     
Gg     , Gg     , Gg     , Gg     , Ch     , Ch     , Ch     , Gg     , Gg     , Gg     , Gg     , Gg     , Gg     , Gs^Fp     , Gg     , Gg     , Gg     , Gs^Fp     , Gs^Fp     , Gs^Fp     , Gs^Fp     , Gs^Fp     , Gs^Fp     , Gs^Fp     , Gs^Fp     , Gs^Fp     , Gs^Fp     , Gs^Fp     , Gg     , Gg     , Gg     , Gg     , Gg     , Gg     , Gg     , Gg     , Gg     , Re^Gvs   , Re^Gvs   , Re^Gvs   , Re^Gvs   , Re^Gvs   , Re^Gvs   , Re^Gvs   , Re^Gvs   , Gg     , Gg     , Gg     , Gg     , Gg     
Gg     , Gg     , Gg     , Gg     , Gg     , Gg     , Gg     , Gg     , Gg     , Gg     , Gg     , Gs^Fp     , Gs^Fp     , Gs^Fp     , Gg     , Gs^Fp     , Gs^Fp     , Gs^Fp     , Gs^Fp     , Gg^Ve    , Gs^Fp     , Gs^Fp     , Gs^Fp     , Gs^Fp     , Gs^Fp     , Gs^Fp     , Gs^Fp     , Gs^Fp     , Gg     , Gs^Fp     , Gg     , Gg     , Gg     , Re     , Re     , Re^Gvs   , Re^Gvs   , Re^Gvs   , Re^Gvs   , Re^Gvs   , Re^Gvs   , Re^Gvs   , Re^Gvs   , Re^Gvs   , Re^Gvs   , Gg     , Gg     , Gg     , Gg     , Gg     
Gg     , Gg     , Gg     , Gg     , Gg     , Gg     , Gg     , Gg     , Gg     , Gg     , Gg     , Gs^Fp     , Gs^Fp     , Gs^Fp     , Gs^Fp     , Gs^Fp     , Gs^Fp     , Gs^Fp     , Gs^Fp     , Gs^Fp     , Gs^Fp     , Gs^Fp     , Gs^Fp     , Gg^Fet    , Gs^Fp     , Gs^Fp     , Gs^Fp     , Gs^Fp     , Gs^Fp     , Gs^Fp     , Gs^Fp     , Gg     , Gg^Vh    , Gg     , Gg     , Re^Gvs   , Re^Gvs   , Re^Gvs   , Re^Gvs   , Re^Gvs   , Re^Gvs   , Re^Gvs   , Re^Gvs   , Gg     , Gg     , Gg     , Gg     , Gg     , Gg     , Gg     
Gg     , Gg     , Gg     , Gg     , Gg     , Gg     , Gg     , Gg     , Gs^Fp     , Gs^Fp     , Gs^Fp     , Gs^Fp     , Gs^Fp     , Gs^Fp     , Gs^Fp     , Gs^Fp     , Gs^Fp     , Gs^Fp     , Gs^Fp     , Gs^Fp     , Gs^Fp     , Gs^Fp     , Gs^Fp     , Gs^Fp     , Gs^Fp     , Gs^Fp     , Gs^Fp     , Gs^Fp     , Gs^Fp     , Gs^Fp     , Gs^Fp     , Gg     , Gg     , Gg     , Gg     , Re^Gvs   , Re^Gvs   , Re^Gvs   , Re^Gvs   , Re^Gvs   , Re^Gvs   , Gg     , Gg     , Gg     , Gg     , Gg     , Gg     , Gg     , Gg     , Gg     
Gg     , Gg     , Gg     , Gg     , Gg     , Gg     , Gg     , Gg     , Gs^Fp     , Gs^Fp     , Gs^Fp     , Gs^Fp     , Gs^Fp     , Gs^Fp     , Gs^Fp     , Gs^Fp     , Gs^Fp     , Gs^Fp     , Gs^Fp     , Gs^Fp     , Gs^Fp     , Gs^Fp     , Gs^Fp     , Gs^Fp     , Gs^Fp     , Gs^Fp     , Gs^Fp     , Gs^Fp     , Gs^Fp     , Gs^Fp     , Gs^Fp     , Gs^Fp     , Gg     , Gg     , Gg     , Gg     , Re^Gvs   , Re^Gvs   , Re^Gvs   , Gg     , Gg     , Gg     , Gg     , Gg     , Gg     , Gg     , Gg     , Gg     , Gg     , Gg     
Gg     , Gg^Vh    , Gg     , Gg     , Gg     , Gg     , Gg     , Gs^Fp     , Gs^Fp     , Gs^Fp     , Gs^Fp     , Gs^Fp     , Gs^Fp     , Gs^Fp     , Gs^Fp     , Gs^Fp     , Gs^Fp     , Gs^Fp     , Gs^Fp     , Gs^Fp     , Gs^Fp     , Gs^Fp     , Gs^Fp     , Gs^Fp     , Gs^Fp     , Gs^Fp     , Gs^Fp     , Gs^Fp     , Gs^Fp     , Gs^Fp     , Gs^Fp     , Gg     , Gg     , Gg     , Gg     , Gg     , Gg     , Gg     , Ww     , Gg     , Gg     , Gg     , Gg     , Gg     , Gg     , Gg     , Gg     , Gg     , Gg     , Gg     
Gg     , Gg     , Gg     , Gg     , Gg     , Gg     , Gs^Fp     , Gs^Fp     , Gs^Fp     , Gs^Fp     , Gg^Ve    , Gs^Fp     , Gs^Fp     , Gs^Fp     , Gs^Fp     , Gs^Fp     , Gs^Fp     , Gs^Fp     , Gs^Fp     , Gs^Fp     , Gs^Fp     , Gs^Fp     , Gs^Fp     , Gs^Fp     , Gg^Ve    , Gs^Fp     , Gs^Fp     , Gs^Fp     , Gs^Fp     , Gs^Fp     , Gs^Fp     , Gs^Fp     , Gg     , Gs^Fp     , Gg     , Gg     , Gg     , Gg     , Ww     , Ww     , Gg     , Gg     , Gg     , Gg     , Gg     , Gg     , Gg     , Gg     , Gg     , Gg     
Gg     , Gg     , Gg     , Gg     , Gg     , Gg     , Gs^Fp     , Gs^Fp     , Gs^Fp     , Gs^Fp     , Gs^Fp     , Gs^Fp     , Gs^Fp     , Gs^Fp     , Gs^Fp     , Gs^Fp     , Gs^Fp     , Gs^Fp     , Gs^Fp     , Gs^Fp     , Gs^Fp     , Gs^Fp     , Gs^Fp     , Gs^Fp     , Gs^Fp     , Gs^Fp     , Gs^Fp     , Gs^Fp     , Gs^Fp     , Gs^Fp     , Gs^Fp     , Gs^Fp     , Gs^Fp     , Gs^Fp     , Gg     , Gg     , Gg     , Gg     , Gg     , Ww     , Ww     , Ww     , Gg     , Re     , Gg     , Gg^Vh    , Gg     , Gg     , Gg     , Gg     
Gg     , Gg     , Gg     , Gg     , Gg     , Gg     , Gg     , Gs^Fp     , Gs^Fp     , Gs^Fp     , Gs^Fp     , Gs^Fp     , Gs^Fp     , Gs^Fp     , Gs^Fp     , Gs^Fp     , Gs^Fp     , Gs^Fp     , Gs^Fp     , Gs^Fp     , Gs^Fp     , Gs^Fp     , Gs^Fp     , Gs^Fp     , Gs^Fp     , Gs^Fp     , Gs^Fp     , Gs^Fp     , Gs^Fp     , Gs^Fp     , Gs^Fp     , Gs^Fp     , Gs^Fp     , Gs^Fp     , Gs^Fp     , Gg     , Gg     , Gg     , Ww     , Ww     , Ww     , Ww     , Ww     , Gg     , Re     , Gg     , Gg     , Gg     , Gg     , Gg     
Gg     , Gg     , Gg     , Gg     , Gg^Vh    , Gg     , Gg     , Gs^Fp     , Gs^Fp     , Gs^Fp     , Gs^Fp     , Gs^Fp     , Gs^Fp     , Gs^Fp     , Gs^Fp     , Gs^Fp     , Gs^Fp     , Gs^Fp     , Gs^Fp     , Gs^Fp     , Gs^Fp     , Gg^Ve    , Gs^Fp     , Gs^Fp     , Gs^Fp     , Gs^Fp     , Gs^Fp     , Gs^Fp     , Gs^Fp     , Gs^Fp     , Gs^Fp     , Gs^Fp     , Gs^Fp     , Gs^Fp     , Gg     , Gg     , Gg     , Gg     , Ww     , Ww     , Ww     , Ww     , Ww     , Gg     , Gg     , Gg     , Gg     , Gg     , Gg     , Gg     
Gg     , Gg     , Gg     , Gg     , Gg     , Gg     , Gs^Fp     , Gs^Fp     , Gs^Fp     , Gs^Fp     , Gs^Fp     , Gs^Fp     , Gs^Fp     , Gs^Fp     , Gs^Fp     , Gs^Fp     , Gs^Fp     , Gs^Fp     , Gs^Fp     , Gs^Fp     , Gs^Fp     , Gs^Fp     , Gs^Fp     , Gs^Fp     , Gs^Fp     , Gs^Fp     , Gs^Fp     , Gs^Fp     , Gs^Fp     , Gs^Fp     , Gs^Fp     , Gs^Fp     , Gs^Fp     , Gg     , Gg     , Gg     , Gg     , Gg     , Gg     , Gg     , Ww     , Gg     , Gg     , Gg     , Gg     , Gg     , Gg     , Gg     , Gg     , Gg     
